protein	Category
0	control
78_kDa_glucose-regulated_protein	
A_kinase_(PRKA)_anchor_protein_3	
actin-like_8	
ADAM_metallopeptidase_domain_29	
aka_CDCA1	
aka_PEPP2	
alpha-1-B_glycoprotein	
Amyloid_Beta_(4)_precursor_protein	
androgen_receptor_[Homo_sapiens]	
anterior_gradient_homolog_2_(Xenopus_laevis)	
ANXA2_annexin_A2	
Apoptosis-inducing_factor_mitochondrion-associated_3_[Homo_sapiens]	
ARHGDIA_Rho_GDP_dissociation_inhibitor_(GDI)_alpha_[_Homo_sapiens_]	
armadillo_repeat_containing_3	
ATF2_activating_transcription_factor_2_[_Homo_sapiens_]	
BCCP_only_(no_Myc_tag)	control
BCCP-Myc	control
bccp1	control
bccp2	control
bccp3	control
bccp4	control
bccp5	control
bccp6	control
beta-galactosidase-BCCP_(no_Myc_tag)	
beta-galactosidase-BCCP-Myc	
brain_abundant_membrane_attached_signal_protein_1	
BSA_1	control
C21orf33_chromosome_21_open_reading_frame_33_[_Homo_sapiens_]_	
calcium_binding_tyrosine-(Y)-phosphorylation_regulated_(fibrousheathin_2)	
CALR_calreticulin_[_Homo_sapiens_]	
Carbonic_anhydrase_IV_	
carbonic_anhydrase_IX_[Homo_sapiens]	
carboxypeptidase_M	
carcinoembryonic_antigen-related_cell_adhesion_molecule_7	
Cas-Br-M_ecotropic_retroviral_transforming_sequence_c_(CBLC)_	
cathepsin_E	
CCNA1_cyclin_A1_[_Homo_sapiens_]	
CCNA2_cyclin_A2_[_Homo_sapiens_]	
CD276_molecule_[Homo_sapiens]	
CDK8_cyclin-dependent_kinase_8_[_Homo_sapiens_]_	
CEACAM1_carcinoembryonic_antigen-related_cell_adhesion_molecule_1_(biliary_glycoprotein)_[_Homo_sapiens_]_	
chitinase_3-like_1_(cartilage_glycoprotein-39)	
Chromosome_1_gene_contig_	
Chromosome_20_gene_contig._	
Chromosome_6_gene_contig_	
chromosome_X_open_reading_frame_48	
chromosome_X_open_reading_frame_61	
coiled-coil_domain_containing_36	
CPX_chromosome_region_candidate_1	
CTSD_cathepsin_D	control
Cy3BSA_1	control
Cy3BSA_10	control
Cy3BSA_11	control
Cy3BSA_12	control
Cy3BSA_13	control
Cy3BSA_14	control
Cy3BSA_15	control
Cy3BSA_16	control
Cy3BSA_17	control
Cy3BSA_18	control
Cy3BSA_19	control
Cy3BSA_2	control
Cy3BSA_20	control
Cy3BSA_21	control
Cy3BSA_22	control
Cy3BSA_23	control
Cy3BSA_3	control
Cy3BSA_4	control
Cy3BSA_5	control
Cy3BSA_6	control
Cy3BSA_7	control
Cy3BSA_8	control
Cy3BSA_9	control
cystatin_S	
cytochrome_c_oxidase_subunit_VIb_polypeptide_2	
cytochrome_P450_family_1_subfamily_B_polypeptide_1_[Homo_sapiens]	
dickkopf_homolog_1_(Xenopus_laevis)	
discoidin_CUB_and_LCCL_domain_containing_2	
dopachrome_tautomerase_(dopachrome_delta-isomerase_tyrosine-related_protein_2)_[Homo_sapiens]	
E6_transforming_protein_[_Human_papillomavirus_type_16_]_	
E7_transforming_protein_[_Human_papillomavirus_type_16_]	
EFHD2_EF-hand_domain_family_member_D2_[_Homo_sapiens_]_	
EIF4A3_eukaryotic_translation_initiation_factor_4A3_[_Homo_sapiens_]_	
EMPTY	EMPTY
EPH_receptor_A2_[Homo_sapiens]	
epithelial_cell_adhesion_molecule_[Homo_sapiens]	
fibroblast_activation_protein_alpha_[Homo_sapiens]	
Frizzled-1_	
FSCN1_fascin_homolog_1_actin-bundling_protein_(Strongylocentrotus_purpuratus)_[_Homo_sapiens_]_	
GAPDH_glyceraldehyde-3-phosphate_dehydrogenase_[_Homo_sapiens_]_	
GDF15_growth_differentiation_factor_15_[_Homo_sapiens_]_	
Glutaminase_2_	
glycoprotein_2_(zymogen_granule_membrane)	
GPA33_glycoprotein_A33_(transmembrane)_[_Homo_sapiens_]_	
heat_shock_protein_alpha-crystallin-related_B9	
hippocalcin-like_1	
HIST1H1C_histone_cluster_1_H1c_[_Homo_sapiens_]_	
HNRNPA2B1_heterogeneous_nuclear_ribonucleoprotein_A2/B1_[_Homo_sapiens_]_	
Homo_sapiens__BIRC3_baculoviral_IAP_repeat-containing_3	
Homo_sapiens__Homo_sapiens_5-aminoimidazole-4-carboxamide_ribonucleotide_formyltransferase/IMP_cyclohyd	
Homo_sapiens__Homo_sapiens_activating_transcription_factor_4_(tax-responsive_enhancer_element_B67)_tra	
Homo_sapiens__Homo_sapiens_apolipoprotein_B	
Homo_sapiens__Homo_sapiens_calcium/calmodulin-dependent_protein_kinase_(CaM_kinase)_II_beta_transcript	
Homo_sapiens__Homo_sapiens_calcium/calmodulin-dependent_protein_kinase_(CaM_kinase)_II_delta_transcrip	
Homo_sapiens__Homo_sapiens_calcium/calmodulin-dependent_protein_kinase_(CaM_kinase)_II_gamma_transcrip	
Homo_sapiens__Homo_sapiens_calcium/calmodulin-dependent_protein_kinase_kinase_1_alpha_transcript_vari	
Homo_sapiens__Homo_sapiens_calcium/calmodulin-dependent_protein_kinase_kinase_2_beta_transcript_varia	
Homo_sapiens__Homo_sapiens_Cbp/p300-interacting_transactivator_with_Glu/Asp-rich_carboxy-terminal_doma	
Homo_sapiens__Homo_sapiens_cDNA	
Homo_sapiens__Homo_sapiens_cyclin-dependent_kinase_inhibitor_2B_(p15_inhibits_CDK4)_transcript_varian	
Homo_sapiens__Homo_sapiens_cyclin-dependent_kinase_inhibitor_2C_(p18_inhibits_CDK4)_transcript_varian	
Homo_sapiens__Homo_sapiens_cyclin-dependent_kinase_inhibitor_2D_(p19_inhibits_CDK4)_transcript_varian	
Homo_sapiens__Homo_sapiens_eukaryotic_translation_elongation_factor_1_delta_(guanine_nucleotide_exchang	
Homo_sapiens__Homo_sapiens_excision_repair_cross-complementing_rodent_repair_deficiency_complementatio	
Homo_sapiens__Homo_sapiens_fibroblast_growth_factor_receptor_2_(bacteria-expressed_kinase_keratinocyte	
Homo_sapiens__Homo_sapiens_fms-related_tyrosine_kinase_1_(vascular_endothelial_growth_factor/vascular_p	
Homo_sapiens__Homo_sapiens_guanine_nucleotide_binding_protein_(G_protein)_alpha_activating_activity_po	
Homo_sapiens__Homo_sapiens_guanine_nucleotide_binding_protein_(G_protein)_alpha_inhibiting_activity_po	
Homo_sapiens__Homo_sapiens_guanine_nucleotide_binding_protein_(G_protein)_gamma_transducing_activity_p	
Homo_sapiens__Homo_sapiens_hypoxia-inducible_factor_1_alpha_subunit_(basic_helix-loop-helix_transcript	
Homo_sapiens__Homo_sapiens_inhibitor_of_DNA_binding_1_dominant_negative_helix-loop-helix_protein_tran	
Homo_sapiens__Homo_sapiens_Machado-Joseph_disease_(spinocerebellar_ataxia_3_olivopontocerebellar_ataxi	
Homo_sapiens__Homo_sapiens_MADS_box_transcription_enhancer_factor_2_polypeptide_A_(myocyte_enhancer_fa	
Homo_sapiens__Homo_sapiens_MADS_box_transcription_enhancer_factor_2_polypeptide_C_(myocyte_enhancer_fa	
Homo_sapiens__Homo_sapiens_matrix_metalloproteinase_2_(gelatinase_A_72kDa_gelatinase_72kDa_type_IV_co	
Homo_sapiens__Homo_sapiens_MCM5_minichromosome_maintenance_deficient_5_cell_division_cycle_46_(S._cere	
Homo_sapiens__Homo_sapiens_Meis1_myeloid_ecotropic_viral_integration_site_1_homolog_2_(mouse)_transcr	
Homo_sapiens__Homo_sapiens_myxovirus_(influenza_virus)_resistance_1_interferon-inducible_protein_p78_(	
Homo_sapiens__Homo_sapiens_nuclear_factor_of_kappa_light_polypeptide_gene_enhancer_in_B-cells_inhibitor	
Homo_sapiens__Homo_sapiens_nudix_(nucleoside_diphosphate_linked_moiety_X)-type_motif_2_transcript_vari	
Homo_sapiens__Homo_sapiens_phosphodiesterase_4A_cAMP-specific_(phosphodiesterase_E2_dunce_homolog_Dro	
Homo_sapiens__Homo_sapiens_phosphoinositide-3-kinase_regulatory_subunit_polypeptide_1_(p85_alpha)_tr	
Homo_sapiens__Homo_sapiens_procollagen-proline_2-oxoglutarate_4-dioxygenase_(proline_4-hydroxylase)_b	
Homo_sapiens__Homo_sapiens_proteasome_(prosome_macropain)_26S_subunit_non-ATPase_4_transcript_varia	
Homo_sapiens__Homo_sapiens_proteasome_(prosome_macropain)_activator_subunit_3_(PA28_gamma_Ki)_transc	
Homo_sapiens__Homo_sapiens_protein_kinase_interferon-inducible_double_stranded_RNA_dependent_activator	
Homo_sapiens__Homo_sapiens_protein_phosphatase_1A_(formerly_2C)_magnesium-dependent_alpha_isoform_tr	
Homo_sapiens__Homo_sapiens_protein_phosphatase_2_(formerly_2A)_regulatory_subunit_B_(PR_52)_beta_isof	
Homo_sapiens__Homo_sapiens_protein_phosphatase_2_(formerly_2A)_regulatory_subunit_B_(PR_52)_gamma_iso	
Homo_sapiens__Homo_sapiens_protein_phosphatase_2_regulatory_subunit_B_(B56)_gamma_isoform_transcript	
Homo_sapiens__Homo_sapiens_protein_phosphatase_3_(formerly_2B)_catalytic_subunit_alpha_isoform_(calci	
Homo_sapiens__Homo_sapiens_protein_phosphatase_3_(formerly_2B)_catalytic_subunit_gamma_isoform_(calci	
Homo_sapiens__Homo_sapiens_protein_phosphatase_3_(formerly_2B)_regulatory_subunit_B_19kDa_alpha_isof	
Homo_sapiens__Homo_sapiens_PRP4_pre-	
Homo_sapiens__Homo_sapiens_ras-related_C3_botulinum_toxin_substrate_1_(rho_family_small_GTP_binding_pr	
Homo_sapiens__Homo_sapiens_ras-related_C3_botulinum_toxin_substrate_2_(rho_family_small_GTP_binding_pr	
Homo_sapiens__Homo_sapiens_regulatory_factor_X_3_(influences_HLA_class_II_expression)_transcript_vari	
Homo_sapiens__Homo_sapiens_RNA_binding_motif_single_stranded_interacting_protein_1_transcript_variant	
Homo_sapiens__Homo_sapiens_signal_transducer_and_activator_of_transcription_3_(acute-phase_response_fac	
Homo_sapiens__Homo_sapiens_solute_carrier_family_25_(mitochondrial_carrier_adenine_nucleotide_transloc	
Homo_sapiens__Homo_sapiens_succinate_dehydrogenase_complex_subunit_C_integral_membrane_protein_15kDa	
Homo_sapiens__Homo_sapiens_TAF6-like_RNA_polymerase_II_p300/CBP-associated_factor_(PCAF)-associated_fa	
Homo_sapiens__Homo_sapiens_TAF9_RNA_polymerase_II_TATA_box_binding_protein_(TBP)-associated_factor_32	
Homo_sapiens__Homo_sapiens_thyroid_hormone_receptor_alpha_(erythroblastic_leukemia_viral_(v-erb-a)_onc	
Homo_sapiens__Homo_sapiens_tissue_inhibitor_of_metalloproteinase_3_(Sorsby_fundus_dystrophy_pseudoinfl	
Homo_sapiens__Homo_sapiens_transcription_factor_2_hepatic_LF-B3_variant_hepatic_nuclear_factor_tran	
Homo_sapiens__Homo_sapiens_tyrosine_3-monooxygenase/tryptophan_5-monooxygenase_activation_protein_epsi	
Homo_sapiens__Homo_sapiens_ubiquitin-activating_enzyme_E1_(A1S9T_and_BN75_temperature_sensitivity_compl	
Homo_sapiens__Homo_sapiens_ubiquitin-conjugating_enzyme_E2I_(UBC9_homolog_yeast)_transcript_variant_1	
Homo_sapiens__Homo_sapiens_v-myc_myelocytomatosis_viral_oncogene_homolog_1_lung_carcinoma_derived_(avi	
Homo_sapiens_2'-5'-oligoadenylate_synthetase_2_69/71kDa	
Homo_sapiens_3-phosphoinositide_dependent_protein_kinase-1	
Homo_sapiens_3'-phosphoadenosine_5'-phosphosulfate_synthase_2	
Homo_sapiens_5-hydroxytryptamine_(serotonin)_receptor_1D	
Homo_sapiens_6-phosphofructo-2-kinase/fructose-26-biphosphatase_3	
Homo_sapiens_6-phosphofructo-2-kinase/fructose-26-biphosphatase_4	
Homo_sapiens_6-pyruvoyl-tetrahydropterin_synthase/dimerization_cofactor_of_hepatocyte_nuc	
Homo_sapiens_8-oxoguanine_DNA_glycosylase_transcript_variant_1a	
Homo_sapiens_aarF_domain_containing_kinase_4	
Homo_sapiens_ABL2_v-abl_Abelson_murine_leukemia_viral_oncogene_homolog_2	
Homo_sapiens_absent_in_melanoma_2	
Homo_sapiens_acetyl-Coenzyme_A_acetyltransferase_2_(acetoacetyl_Coenzyme_A_thiolase)	
Homo_sapiens_achaete-scute_complex-like_1_(Drosophila)	
Homo_sapiens_ACSL6_acyl-CoA_synthetase_long-chain_family_member_6	
Homo_sapiens_actin_alpha_1_skeletal_muscle	
Homo_sapiens_actin_beta	
Homo_sapiens_activated_p21cdc42Hs_kinase	
Homo_sapiens_activated_RNA_polymerase_II_transcription_cofactor_4	
Homo_sapiens_activating_transcription_factor_1	
Homo_sapiens_activating_transcription_factor_3	
Homo_sapiens_activating_transcription_factor_5	
Homo_sapiens_activation-induced_cytidine_deaminase	
Homo_sapiens_activator_of_basal_transcription_1	
Homo_sapiens_activin_A_receptor_type_I	
Homo_sapiens_activin_A_receptor_type_IC	
Homo_sapiens_activin_A_receptor_type_II_mRNA_(cDNA_clone_MGC:97294_)	
Homo_sapiens_ACTL7B_actin-like_7B	
Homo_sapiens_adaptor-related_protein_complex_2_mu_1_subunit	
Homo_sapiens_ADCK1_aarF_domain_containing_kinase_1	
Homo_sapiens_adducin_1_(alpha)	
Homo_sapiens_adenosylmethionine_decarboxylase_1	
Homo_sapiens_adenovirus_5_E1A_binding_protein	
Homo_sapiens_adenylate_kinase_1	
Homo_sapiens_adenylate_kinase_2_transcript_variant_AK2A	
Homo_sapiens_adenylate_kinase_3	
Homo_sapiens_adenylate_kinase_3-like_1_transcript_variant_3	
Homo_sapiens_adenylate_kinase_7	
Homo_sapiens_adenylosuccinate_lyase	
Homo_sapiens_ADP-ribosylation_factor-like_1	
Homo_sapiens_adrenergic_beta_receptor_kinase_1	
Homo_sapiens_adrenergic_beta_receptor_kinase_2	
Homo_sapiens_AF4/FMR2_family_member_4	
Homo_sapiens_AIFM1_apoptosis-inducing_factor_mitochondrion-associated_1	
Homo_sapiens_alanyl-tRNA_synthetase	
Homo_sapiens_aldolase_A_fructose-bisphosphate_transcript_variant_1	
Homo_sapiens_ALL1-fused_gene_from_chromosome_1q	
Homo_sapiens_allograft_inflammatory_factor_1_transcript_variant_3	
Homo_sapiens_alpha-2-HS-glycoprotein	
Homo_sapiens_alpha-fetoprotein	
Homo_sapiens_alpha-kinase_1_mRNA_(cDNA_clone_MGC:71554_)	
Homo_sapiens_alveolar_soft_part_sarcoma_chromosome_region_candidate_1	
Homo_sapiens_aminomethyltransferase_(glycine_cleavage_system_protein_T)	
Homo_sapiens_amyloid_beta_precursor_protein_binding_protein_1_transcript_variant_1	
Homo_sapiens_amyloid_P_component_serum	
Homo_sapiens_amyotrophic_lateral_sclerosis_2_(juvenile)_chromosome_region_candidate_2	
Homo_sapiens_angiomotin_like_2	
Homo_sapiens_ankyrin_repeat_and_SOCS_box-containing_1	
Homo_sapiens_ankyrin_repeat_domain_13	
Homo_sapiens_annexin_A1	
Homo_sapiens_annexin_A11_transcript_variant_b	
Homo_sapiens_aortic_preferentially_expressed_protein_1	
Homo_sapiens_AP2_associated_kinase_1	
Homo_sapiens_APEX_nuclease_(multifunctional_DNA_repair_enzyme)_1_transcript_variant_1	
Homo_sapiens_APG12_autophagy_12-like_(S._cerevisiae)	
Homo_sapiens_apoptosis_inhibitor_5	
Homo_sapiens_apoptosis-inducing_factor_(AIF)-like_mitochondrion-associated_inducer_of_death	
Homo_sapiens_APPL1_adaptor_protein_phosphotyrosine_interaction_PH_domain_and_leucine_zipper_containing_1	
Homo_sapiens_arachidonate_15-lipoxygenase	
Homo_sapiens_arachidonate_15-lipoxygenase_second_type	
Homo_sapiens_ariadne_homolog_2_(Drosophila)	
Homo_sapiens_ARNT_aryl_hydrocarbon_receptor_nuclear_translocator	
Homo_sapiens_ARP2_actin-related_protein_2_homolog_(yeast)	
Homo_sapiens_arrestin_beta_1_transcript_variant_1	
Homo_sapiens_arsA_arsenite_transporter_ATP-binding_homolog_1_(bacterial)	
Homo_sapiens_ATP-binding_cassette_sub-family_F_(GCN20)_member_1	
Homo_sapiens_ATP-binding_cassette_sub-family_F_(GCN20)_member_3	
Homo_sapiens_ATP5B_ATP_synthase_H+_transporting_mitochondrial_F1_complex_beta_polypeptide	
Homo_sapiens_axin_1_transcript_variant_2	
Homo_sapiens_AXIN1_up-regulated_1	
Homo_sapiens_AXL_receptor_tyrosine_kinase_transcript_variant_1	
Homo_sapiens_B_lymphoid_tyrosine_kinase	
Homo_sapiens_B-cell_scaffold_protein_with_ankyrin_repeats_1	
Homo_sapiens_B-cell_translocation_gene_1_anti-proliferative	
Homo_sapiens_bactericidal/permeability-increasing_protein	
Homo_sapiens_baculoviral_IAP_repeat-containing_2	
Homo_sapiens_baculoviral_IAP_repeat-containing_4	
Homo_sapiens_baculoviral_IAP_repeat-containing_5_(survivin)	
Homo_sapiens_baculoviral_IAP_repeat-containing_7_(livin)_transcript_variant_1	
Homo_sapiens_basic_leucine_zipper_nuclear_factor_1_(JEM-1)	
Homo_sapiens_basic_leucine_zipper_transcription_factor_ATF-like	
Homo_sapiens_basic_transcription_factor_3	
Homo_sapiens_BAX_BCL2-associated_X_protein	
Homo_sapiens_BCL10_B-cell_CLL/lymphoma_10	
Homo_sapiens_BCL2-antagonist_of_cell_death_transcript_variant_1	
Homo_sapiens_BCL2-associated_athanogene_3	
Homo_sapiens_BCL2-associated_athanogene_4	
Homo_sapiens_BCL2-related_protein_A1	
Homo_sapiens_BCL2L14_BCL2-like_14_(apoptosis_facilitator)	
Homo_sapiens_BCR_breakpoint_cluster_region	
Homo_sapiens_BCR_downstream_signaling_1	
Homo_sapiens_beta-transducin_repeat_containing_transcript_variant_1	
Homo_sapiens_BID_BH3_interacting_domain_death_agonist	
Homo_sapiens_BLK_B_lymphoid_tyrosine_kinase	
Homo_sapiens_block_of_proliferation_1	
Homo_sapiens_BMPR1B_bone_morphogenetic_protein_receptor_type_IB	
Homo_sapiens_BMX_non-receptor_tyrosine_kinase	
Homo_sapiens_bolA-like_3_(E._coli)	
Homo_sapiens_bone_morphogenetic_protein_7_(osteogenic_protein_1)	
Homo_sapiens_bone_morphogenetic_protein_receptor_type_IA	
Homo_sapiens_bone_morphogenetic_protein_receptor_type_II_(serine/threonine_kinase)_mRNA_(cDNA_clone_MGC:60135_)	
Homo_sapiens_BR_serine/threonine_kinase_1	
Homo_sapiens_BR_serine/threonine_kinase_2_(BRSK2)	
Homo_sapiens_brain-derived_neurotrophic_factor_transcript_variant_5	
Homo_sapiens_branched_chain_alpha-ketoacid_dehydrogenase_kinase	
Homo_sapiens_bromodomain_containing_2_mRNA_(cDNA_clone_MGC:74927_)	
Homo_sapiens_bromodomain_containing_3	
Homo_sapiens_bromodomain_containing_8	
Homo_sapiens_BTB_and_CNC_homology_1_basic_leucine_zipper_transcription_factor_1	
Homo_sapiens_BTG_family_member_3	
Homo_sapiens_BUB1_budding_uninhibited_by_benzimidazoles_1_homolog_(yeast)_clone_MGC:39991	
Homo_sapiens_BUB1_budding_uninhibited_by_benzimidazoles_1_homolog_beta_(yeast)	
Homo_sapiens_c-fos_induced_growth_factor_(vascular_endothelial_growth_factor_D)	
Homo_sapiens_c-myc_binding_protein	
Homo_sapiens_c-src_tyrosine_kinase_(CSK)	
Homo_sapiens_C-terminal_binding_protein_2	
Homo_sapiens_C017236_Homo_sapiens_casein_kinase_1_gamma_1	
Homo_sapiens_C4BPA_complement_component_4_binding_protein_alpha	
Homo_sapiens_cadherin_19_type_2	
Homo_sapiens_calcium_regulated_heat_stable_protein_1_24kDa	
Homo_sapiens_calcium/calmodulin-dependent_protein_kinase_I_(CAMK1)	
Homo_sapiens_calcium/calmodulin-dependent_protein_kinase_IG	
Homo_sapiens_calcium/calmodulin-dependent_protein_kinase_IV	
Homo_sapiens_calmodulin_1_(phosphorylase_kinase_delta)	
Homo_sapiens_calmodulin_2_(phosphorylase_kinase_delta)	
Homo_sapiens_calmodulin_3_(phosphorylase_kinase_delta)	
Homo_sapiens_calponin_1_basic_smooth_muscle	
Homo_sapiens_calsenilin_presenilin_binding_protein_EF_hand_transcription_factor	
Homo_sapiens_calumenin	
Homo_sapiens_CAMK2A_calcium/calmodulin-dependent_protein_kinase_II_alpha	
Homo_sapiens_CAMK2G_calcium/calmodulin-dependent_protein_kinase_II_gamma	
Homo_sapiens_cAMP_responsive_element_binding_protein_1_transcript_variant_B	
Homo_sapiens_cAMP-regulated_guanine_nucleotide_exchange_factor_II	
Homo_sapiens_cancer/testis_antigen_2_transcript_variant_2	
Homo_sapiens_cannabinoid_receptor_interacting_protein_1	
Homo_sapiens_carbohydrate_(N-acetylglucosamine_6-O)_sulfotransferase_4	
Homo_sapiens_carbohydrate_kinase-like	
Homo_sapiens_carbonic_anhydrase_I	
Homo_sapiens_carboxypeptidase_A4	
Homo_sapiens_carcinoembryonic_antigen-related_cell_adhesion_molecule_8	
Homo_sapiens_carnitine_O-octanoyltransferase	
Homo_sapiens_cartilage_paired-class_homeoprotein_1	
Homo_sapiens_casein_kinase	
Homo_sapiens_casein_kinase_1_delta_transcript_variant_1	
Homo_sapiens_casein_kinase_1_gamma_2	
Homo_sapiens_casein_kinase_2_alpha_1_polypeptide_transcript_variant_2	
Homo_sapiens_casein_kinase_2_alpha_prime_polypeptide	
Homo_sapiens_CASP2_and_RIPK1_domain_containing_adaptor_with_death_domain	
Homo_sapiens_CASP2_caspase_2_apoptosis-related_cysteine_peptidase	
Homo_sapiens_caspase_1_apoptosis-related_cysteine_protease_(interleukin_1_beta_convertase)_transcript	
Homo_sapiens_caspase_10_apoptosis-related_cysteine_protease	
Homo_sapiens_caspase_3_apoptosis-related_cysteine_protease_transcript_variant_alpha	
Homo_sapiens_caspase_4_apoptosis-related_cysteine_protease_transcript_variant_alpha	
Homo_sapiens_caspase_6_apoptosis-related_cysteine_protease_transcript_variant_alpha	
Homo_sapiens_caspase_7_apoptosis-related_cysteine_protease_transcript_variant_alpha	
Homo_sapiens_caspase_9_apoptosis-related_cysteine_protease_transcript_variant_alpha	
Homo_sapiens_caspase_recruitment_domain_family_member_9	
Homo_sapiens_CASS4_Cas_scaffolding_protein_family_member_4	
Homo_sapiens_CCAAT/enhancer_binding_protein_(C/EBP)_gamma	
Homo_sapiens_CCR4-NOT_transcription_complex_subunit_2	
Homo_sapiens_CCR4-NOT_transcription_complex_subunit_7	
Homo_sapiens_CCR4-NOT_transcription_complex_subunit_8	
Homo_sapiens_CD27-binding_(Siva)_protein_transcript_variant_2	
Homo_sapiens_CD5_antigen-like_(scavenger_receptor_cysteine_rich_family)	
Homo_sapiens_CD96_antigen	
Homo_sapiens_CDC-like_kinase_1	
Homo_sapiens_CDC-like_kinase_2_transcript_variant_phclk2	
Homo_sapiens_CDC-like_kinase_3_transcript_variant_phclk3	
Homo_sapiens_CDC-like_kinase_4_(CLK4)	
Homo_sapiens_CDC20_cell_division_cycle_20_homolog_(S._cerevisiae)	
Homo_sapiens_CDC28_protein_kinase_regulatory_subunit_1B	
Homo_sapiens_CDK15_cyclin-dependent_kinase_15	
Homo_sapiens_CDK2_cyclin-dependent_kinase_2	
Homo_sapiens_CDK3_cyclin-dependent_kinase_3	
Homo_sapiens_CDK4_cyclin-dependent_kinase_4	
Homo_sapiens_cDNA	
Homo_sapiens_cDNA_clone_MGC:22915__complete_cds	
Homo_sapiens_cDNA_clone_MGC:70754__complete_cds	
Homo_sapiens_cDNA_clone_MGC:88635__complete_cds	
Homo_sapiens_cell_cycle_related_kinase	
Homo_sapiens_cell_death-inducing_DFFA-like_effector_b	
Homo_sapiens_cell_death-inducing_DFFA-like_effector_c	
Homo_sapiens_cell_division_cycle_2_G1_to_S_and_G2_to_M_transcript_variant_1	
Homo_sapiens_cell_division_cycle_2-like_1_(PITSLRE_proteins)_(CDC2L1)_transcript_variant_6	
Homo_sapiens_cell_division_cycle_2-like_6_(CDK8-like)	
Homo_sapiens_cell_division_cycle_25A	
Homo_sapiens_cell_division_cycle_25B_transcript_variant_3	
Homo_sapiens_cell_division_cycle_25C_transcript_variant_1	
Homo_sapiens_cell_division_cycle_42_(GTP_binding_protein_25kDa)_transcript_variant_1	
Homo_sapiens_chaperone_ABC1_activity_of_bc1_complex_like_(S._pombe)	
Homo_sapiens_chaperonin_containing_TCP1_subunit_3_(gamma)	
Homo_sapiens_chaperonin_containing_TCP1_subunit_5_(epsilon)	
Homo_sapiens_chemokine_(C-C_motif)_receptor_5	
Homo_sapiens_chemokine_(C-X-C_motif)_receptor_4_transcript_variant_2	
Homo_sapiens_chemokine_(C-X-C_motif)_receptor_6	
Homo_sapiens_chimerin_(chimaerin)_1	
Homo_sapiens_CHK1_checkpoint_homolog_(S._pombe)	
Homo_sapiens_CHK2_checkpoint_homolog_(S._pombe)_transcript_variant_1	
Homo_sapiens_chromobox_homolog_5_(HP1_alpha_homolog_Drosophila)	
Homo_sapiens_chromosome_1_open_reading_frame_33	
Homo_sapiens_chromosome_1_open_reading_frame_57	
Homo_sapiens_chromosome_14_open_reading_frame_11	
Homo_sapiens_chromosome_14_open_reading_frame_163_transcript_variant_1	
Homo_sapiens_chromosome_20_open_reading_frame_43	
Homo_sapiens_chromosome_20_open_reading_frame_64	
Homo_sapiens_chromosome_20_open_reading_frame_97	
Homo_sapiens_chromosome_21_open_reading_frame_124	
Homo_sapiens_chromosome_21_open_reading_frame_2	
Homo_sapiens_chromosome_6_open_reading_frame_11	
Homo_sapiens_chromosome_6_open_reading_frame_199	
Homo_sapiens_chromosome_6_open_reading_frame_93	
Homo_sapiens_chromosome_7_open_reading_frame_22	
Homo_sapiens_chromosome_9_open_reading_frame_115	
Homo_sapiens_chromosome_9_open_reading_frame_86	
Homo_sapiens_chromosome_9_open_reading_frame_96_mRNA_(cDNA_clone_MGC:43306_)	
Homo_sapiens_coactosin-like_1_(Dictyostelium)	
Homo_sapiens_coatomer_protein_complex_subunit_gamma_2	
Homo_sapiens_cofactor_required_for_Sp1_transcriptional_activation_subunit_6_77kDa	
Homo_sapiens_cofilin_1_(non-muscle)	
Homo_sapiens_COMM_domain_containing_3	
Homo_sapiens_complement_component_6	
Homo_sapiens_cone-rod_homeobox	
Homo_sapiens_COP9_constitutive_photomorphogenic_homolog_subunit_6_(Arabidopsis)	
Homo_sapiens_COPB2_coatomer_protein_complex_subunit_beta_2_(beta_prime)	
Homo_sapiens_core_promoter_element_binding_protein	
Homo_sapiens_core-binding_factor_beta_subunit_transcript_variant_2	
Homo_sapiens_core-binding_factor_runt_domain_alpha_subunit_2_translocated_to_1_cycli	
Homo_sapiens_core-binding_factor_runt_domain_alpha_subunit_2_translocated_to_3	
Homo_sapiens_CpG_binding_protein	
Homo_sapiens_creatine_kinase_brain	
Homo_sapiens_creatine_kinase_mitochondrial_2_(sarcomeric)	
Homo_sapiens_creatine_kinase_muscle	
Homo_sapiens_CREB5_cAMP_responsive_element_binding_protein_5	
Homo_sapiens_crystallin_alpha_B	
Homo_sapiens_CSNK1E_casein_kinase_1_epsilon	
Homo_sapiens_CTNNB1_catenin_(cadherin-associated_protein)_beta_1_88kDa	
Homo_sapiens_CTNNBL1_catenin_beta_like_1	
Homo_sapiens_CUL5_cullin_5	
Homo_sapiens_cullin_1	
Homo_sapiens_cullin_4A_transcript_variant_1	
Homo_sapiens_cyclin_B1	
Homo_sapiens_cyclin_D1_(PRAD1:_parathyroid_adenomatosis_1)	
Homo_sapiens_cyclin_D2	
Homo_sapiens_cyclin_H	
Homo_sapiens_cyclin_I	
Homo_sapiens_cyclin-dependent_kinase_(CDC2-like)_10	
Homo_sapiens_cyclin-dependent_kinase_2_transcript_variant_1	
Homo_sapiens_cyclin-dependent_kinase_4_transcript_variant_1	
Homo_sapiens_cyclin-dependent_kinase_5	
Homo_sapiens_cyclin-dependent_kinase_5_regulatory_subunit_1_(p35)	
Homo_sapiens_cyclin-dependent_kinase_7_(MO15_homolog_Xenopus_laevis_cdk-activating_kina	
Homo_sapiens_cyclin-dependent_kinase_9_(CDC2-related_kinase)	
Homo_sapiens_cyclin-dependent_kinase_inhibitor_1A_(p21_Cip1)_transcript_variant_1	
Homo_sapiens_cyclin-dependent_kinase_inhibitor_2A_(melanoma_p16_inhibits_CDK4)	
Homo_sapiens_cylindromatosis_(turban_tumor_syndrome)	
Homo_sapiens_cystatin_B_(stefin_B)	
Homo_sapiens_cysteine_dioxygenase_type_I	
Homo_sapiens_cysteine-rich_hydrophobic_domain_2	
Homo_sapiens_cytidylate_kinase	
Homo_sapiens_cytochrome_c_oxidase_subunit_VIc	
Homo_sapiens_cytochrome_c_somatic	
Homo_sapiens_cytokine_inducible_SH2-containing_protein_transcript_variant_2	
Homo_sapiens_cytoskeleton-associated_protein_1	
Homo_sapiens_D4_zinc_and_double_PHD_fingers_family_2	
Homo_sapiens_damage-specific_DNA_binding_protein_1_127kDa	
Homo_sapiens_damage-specific_DNA_binding_protein_2_48kDa	
Homo_sapiens_DAPK1_death-associated_protein_kinase_1	
Homo_sapiens_DEAD_(Asp-Glu-Ala-Asp)_box_polypeptide_5	
Homo_sapiens_DEAD_(Asp-Glu-Ala-Asp)_box_polypeptide_55	
Homo_sapiens_death_effector_domain_containing_transcript_variant_1	
Homo_sapiens_death-associated_protein_kinase_2_(DAPK2)	
Homo_sapiens_DEK_oncogene_(DNA_binding)	
Homo_sapiens_deoxyguanosine_kinase_transcript_variant_1	
Homo_sapiens_deoxynucleotidyltransferase_terminal	
Homo_sapiens_deoxythymidylate_kinase_(thymidylate_kinase)	
Homo_sapiens_diacylglycerol_kinase_alpha_80kDa_transcript_variant_2	
Homo_sapiens_discoidin_domain_receptor_family_member_1_transcript_variant_2	
Homo_sapiens_discoidin_domain_receptor_family_member_1_transcript_variant_2_mRNA_(cDNA_clone_MGC:3909_)	
Homo_sapiens_dishevelled_dsh_homolog_2_(Drosophila)	
Homo_sapiens_dishevelled_dsh_homolog_3_(Drosophila)	
Homo_sapiens_distal-less_homeo_box_1	
Homo_sapiens_distal-less_homeo_box_3	
Homo_sapiens_distal-less_homeobox_4_transcript_variant_1	
Homo_sapiens_DMRT-like_family_B_with_proline-rich_C-terminal_1	
Homo_sapiens_DMRT-like_family_C2	
Homo_sapiens_DNA_(cytosine-5-)-methyltransferase_3-like_transcript_variant_2	
Homo_sapiens_DNA_fragmentation_factor_45kDa_alpha_polypeptide_transcript_variant_1	
Homo_sapiens_DNA_methyltransferase_1_associated_protein_1	
Homo_sapiens_DNA_segment_on_chromosome_6(unique)_2654_expressed_sequence	
Homo_sapiens_DNA-damage-inducible_transcript_3	
Homo_sapiens_DnaJ_(Hsp40)_homolog_subfamily_A_member_1	
Homo_sapiens_DnaJ_(Hsp40)_homolog_subfamily_A_member_2	
Homo_sapiens_DnaJ_(Hsp40)_homolog_subfamily_B_member_1	
Homo_sapiens_dom-3_homolog_Z_(C._elegans)	
Homo_sapiens_doublecortin_domain_containing_2	
Homo_sapiens_doublecortin-like_kinase_1	
Homo_sapiens_Down_syndrome_critical_region_gene_1	
Homo_sapiens_down-regulator_of_transcription_1_TBP-binding_(negative_cofactor_2)	
Homo_sapiens_DRD2_dopamine_receptor_D2	
Homo_sapiens_dual_specificity_phosphatase_10_transcript_variant_1	
Homo_sapiens_dual_specificity_phosphatase_11_(RNA/RNP_complex_1-interacting)	
Homo_sapiens_dual_specificity_phosphatase_12	
Homo_sapiens_dual_specificity_phosphatase_13	
Homo_sapiens_dual_specificity_phosphatase_14	
Homo_sapiens_dual_specificity_phosphatase_18	
Homo_sapiens_dual_specificity_phosphatase_24_(putative)	
Homo_sapiens_dual_specificity_phosphatase_4_transcript_variant_1	
Homo_sapiens_dual_specificity_phosphatase_6_transcript_variant_1	
Homo_sapiens_dual-specificity_tyrosine-(Y)-phosphorylation_regulated_kinase_2	
Homo_sapiens_dual-specificity_tyrosine-(Y)-phosphorylation_regulated_kinase_2_transcript	
Homo_sapiens_dual-specificity_tyrosine-(Y)-phosphorylation_regulated_kinase_4	
Homo_sapiens_dynamin_1-like_transcript_variant_2	
Homo_sapiens_dynamin_2	
Homo_sapiens_dynein_cytoplasmic_light_intermediate_polypeptide_2	
Homo_sapiens_DYRK3_dual-specificity_tyrosine-(Y)-phosphorylation_regulated_kinase_3	
Homo_sapiens_dystrophia_myotonica-protein_kinase_mRNA_(cDNA_clone_MGC:71319_)	
Homo_sapiens_E1B-55kDa-associated_protein_5	
Homo_sapiens_E2F_transcription_factor_6	
Homo_sapiens_E74-like_factor_1_(ets_domain_transcription_factor)	
Homo_sapiens_E74-like_factor_2_(ets_domain_transcription_factor)	
Homo_sapiens_E74-like_factor_4_(ets_domain_transcription_factor)	
Homo_sapiens_E74-like_factor_5_(ets_domain_transcription_factor)	
Homo_sapiens_early_growth_response_2_(Krox-20_homolog_Drosophila)	
Homo_sapiens_ELK1_member_of_ETS_oncogene_family	
Homo_sapiens_ELK3_ETS-domain_protein_(SRF_accessory_protein_2)	
Homo_sapiens_ELMO_domain_containing_1	
Homo_sapiens_elongation_factor_RNA_polymerase_II-like_3	
Homo_sapiens_elongation_factor-2_kinase	
Homo_sapiens_embryonal_Fyn-associated_substrate_transcript_variant_2	
Homo_sapiens_ems1_sequence_(mammary_tumor_and_squamous_cell_carcinoma-associated_(p80/85	
Homo_sapiens_engulfment_and_cell_motility_3_(ced-12_homolog_C._elegans)	
Homo_sapiens_enhancer_of_zeste_homolog_2_(Drosophila)_transcript_variant_1	
Homo_sapiens_enolase_1_(alpha)	
Homo_sapiens_enolase_2_(gamma_neuronal)	
Homo_sapiens_EPAS1_endothelial_PAS_domain_protein_1	
Homo_sapiens_EPH_receptor_A10	
Homo_sapiens_EPH_receptor_A3	
Homo_sapiens_EPH_receptor_B4_mRNA_(cDNA_clone_MGC:59690_)	
Homo_sapiens_EPHB1_EPH_receptor_B1	
Homo_sapiens_EPHB3_EPH_receptor_B3	
Homo_sapiens_epidermal_growth_factor_receptor_(erythroblastic_leukemia_viral_(v-erb-b)_oncogene_homolog_avian)	
Homo_sapiens_EPS15_epidermal_growth_factor_receptor_pathway_substrate_15	
Homo_sapiens_ERBB3_v-erb-b2_erythroblastic_leukemia_viral_oncogene_homolog_3_(avian)	
Homo_sapiens_ERG_v-ets_erythroblastosis_virus_E26_oncogene_homolog	
Homo_sapiens_estrogen_receptor_2_(ER_beta)	
Homo_sapiens_estrogen-related_receptor_gamma	
Homo_sapiens_ethanolamine_kinase_2	
Homo_sapiens_ets_homologous_factor	
Homo_sapiens_ets_variant_gene_4_(E1A_enhancer_binding_protein_E1AF)	
Homo_sapiens_ets_variant_gene_6_(TEL_oncogene)	
Homo_sapiens_ets_variant_gene_7_(TEL2_oncogene)	
Homo_sapiens_eukaryotic_translation_elongation_factor_1_alpha_1	
Homo_sapiens_eukaryotic_translation_elongation_factor_1_gamma	
Homo_sapiens_eukaryotic_translation_initiation_factor_4A_isoform_2	
Homo_sapiens_eukaryotic_translation_initiation_factor_4E	
Homo_sapiens_eukaryotic_translation_initiation_factor_4E_binding_protein_1	
Homo_sapiens_Ewing_sarcoma_breakpoint_region_1_transcript_variant_EWS	
Homo_sapiens_excision_repair_cross-complementing_rodent_repair_deficiency_complementatio	
Homo_sapiens_exosome_complex_exonuclease_RRP41	
Homo_sapiens_exosome_component_10_transcript_variant_1	
Homo_sapiens_exosome_component_8	
Homo_sapiens_exostoses_(multiple)_1	
Homo_sapiens_exostoses_(multiple)_2	
Homo_sapiens_ezrin-binding_partner_PACE-1_transcript_variant_1	
Homo_sapiens_F-box_only_protein_9	
Homo_sapiens_Fanconi_anemia_complementation_group_C	
Homo_sapiens_Fanconi_anemia_complementation_group_G	
Homo_sapiens_Fas_(TNFRSF6)_associated_factor_1_transcript_variant_1	
Homo_sapiens_Fas_(TNFRSF6)-associated_via_death_domain	
Homo_sapiens_Fas_apoptotic_inhibitory_molecule	
Homo_sapiens_FAST_kinase	
Homo_sapiens_FAST_kinase_transcript_variant_2	
Homo_sapiens_feline_sarcoma_oncogene	
Homo_sapiens_ferritin_heavy_polypeptide_1	
Homo_sapiens_FGFR1_fibroblast_growth_factor_receptor_1	
Homo_sapiens_fibroblast_growth_factor_1_(acidic)	
Homo_sapiens_fibroblast_growth_factor_13_transcript_variant_1A	
Homo_sapiens_fibroblast_growth_factor_receptor_1_(fms-related_tyrosine_kinase_2_Pfeiffer_syndrome)_transcript_variant_2	
Homo_sapiens_fibroblast_growth_factor_receptor_2_(bacteria-expressed_kinase_keratinocyte_growth_factor_receptor_craniofacial_dysostosis_1_Crouzon_syndrome_Pfeiffer_syndrome_Jackson-Weiss_syndrome)	
Homo_sapiens_fibroblast_growth_factor_receptor_4_transcript_variant_3	
Homo_sapiens_fibroblast_growth_factor_receptor_substrate_2	
Homo_sapiens_FIP1_like_1_(S._cerevisiae)	
Homo_sapiens_FK506_binding_protein_3_25kDa	
Homo_sapiens_FK506_binding_protein_5	
Homo_sapiens_FKBP1B_FK506_binding_protein_1B	
Homo_sapiens_flap_structure-specific_endonuclease_1	
Homo_sapiens_folate_hydrolase_(prostate-specific_membrane_antigen)_1	
Homo_sapiens_folliculin_transcript_variant_2	
Homo_sapiens_forkhead_box_A3	
Homo_sapiens_forkhead_box_I1_transcript_variant_2	
Homo_sapiens_forkhead_box_M1	
Homo_sapiens_forkhead_box_R2	
Homo_sapiens_forkhead-like_18_(Drosophila)	
Homo_sapiens_formin_homology_2_domain_containing_2	
Homo_sapiens_FOS-like_antigen_1	
Homo_sapiens_FOS-like_antigen_2	
Homo_sapiens_Friend_leukemia_virus_integration_1	
Homo_sapiens_fructosamine_3_kinase	
Homo_sapiens_FtsJ_homolog_3_(E._coli)	
Homo_sapiens_fumarate_hydratase	
Homo_sapiens_fusion_(involved_in_t(1216)_in_malignant_liposarcoma)	
Homo_sapiens_FYN_oncogene_related_to_SRC_FGR_YES	
Homo_sapiens_FYN_oncogene_related_to_SRC_FGR_YES_transcript_variant_3	
Homo_sapiens_fyn-related_kinase	
Homo_sapiens_G_protein-coupled_receptor_kinase_5_mRNA_(cDNA_clone_MGC:71228_)	
Homo_sapiens_G_protein-coupled_receptor_kinase_6	
Homo_sapiens_G6PD_glucose-6-phosphate_dehydrogenase	
Homo_sapiens_galactokinase_1	
Homo_sapiens_GATA_binding_protein_1_(globin_transcription_factor_1)	
Homo_sapiens_GATA_binding_protein_3	
Homo_sapiens_GCN5_general_control_of_amino-acid_synthesis_5-like_2_(yeast)	
Homo_sapiens_general_transcription_factor_IIA_2_12kDa	
Homo_sapiens_general_transcription_factor_IIB	
Homo_sapiens_general_transcription_factor_IIE_polypeptide_2_beta_34kDa	
Homo_sapiens_general_transcription_factor_IIF_polypeptide_1_74kDa	
Homo_sapiens_general_transcription_factor_IIF_polypeptide_2_30kDa	
Homo_sapiens_general_transcription_factor_IIH_polypeptide_1_62kDa	
Homo_sapiens_general_transcription_factor_IIH_polypeptide_2_44kDa	
Homo_sapiens_gephyrin	
Homo_sapiens_geranylgeranyl_diphosphate_synthase_1	
Homo_sapiens_glial_fibrillary_acidic_protein	
Homo_sapiens_glioma-amplified_sequence-41	
Homo_sapiens_glucocorticoid_modulatory_element_binding_protein_1_transcript_variant_2	
Homo_sapiens_glucocorticoid_modulatory_element_binding_protein_2	
Homo_sapiens_glutamate-cysteine_ligase_catalytic_subunit	
Homo_sapiens_glutamic-oxaloacetic_transaminase_1_soluble_(aspartate_aminotransferase_1)	
Homo_sapiens_glutathione_S-transferase_theta_1	
Homo_sapiens_glycerol_kinase_2	
Homo_sapiens_glycerol_kinase_transcript_variant_2	
Homo_sapiens_glycogen_synthase_kinase_3_beta	
Homo_sapiens_glypican_3	
Homo_sapiens_golgi_autoantigen_golgin_subfamily_a_5	
Homo_sapiens_GPX1_glutathione_peroxidase_1	
Homo_sapiens_GRB2-related_adaptor_protein_2	
Homo_sapiens_GRM3_glutamate_receptor_metabotropic_3	
Homo_sapiens_growth_arrest_and_DNA-damage-inducible_gamma	
Homo_sapiens_growth_arrest-specific_2_transcript_variant_2	
Homo_sapiens_growth_arrest-specific_7	
Homo_sapiens_growth_factor_receptor-bound_protein_10	
Homo_sapiens_growth_factor_receptor-bound_protein_2	
Homo_sapiens_growth_factor_receptor-bound_protein_7	
Homo_sapiens_GTP_binding_protein_1	
Homo_sapiens_GTP_binding_protein_overexpressed_in_skeletal_muscle_transcript_variant_2	
Homo_sapiens_guanine_monphosphate_synthetase	
Homo_sapiens_guanine_nucleotide_binding_protein_(G_protein)_alpha_15_(Gq_class)	
Homo_sapiens_guanine_nucleotide_binding_protein_(G_protein)_alpha_z_polypeptide	
Homo_sapiens_guanine_nucleotide_binding_protein_(G_protein)_beta_polypeptide_1	
Homo_sapiens_guanine_nucleotide_binding_protein_(G_protein)_beta_polypeptide_3	
Homo_sapiens_guanine_nucleotide_binding_protein_(G_protein)_gamma_11	
Homo_sapiens_guanine_nucleotide_binding_protein_(G_protein)_gamma_2	
Homo_sapiens_guanine_nucleotide_binding_protein_(G_protein)_gamma_3	
Homo_sapiens_guanine_nucleotide_binding_protein_(G_protein)_gamma_4	
Homo_sapiens_guanylate_kinase_1	
Homo_sapiens_H2.0-like_homeo_box_1_(Drosophila)	
Homo_sapiens_H2A_histone_family_member_Y	
Homo_sapiens_hairy_and_enhancer_of_split_6_(Drosophila)	
Homo_sapiens_hairy/enhancer-of-split_related_with_YRPW_motif-like	
Homo_sapiens_heart_and_neural_crest_derivatives_expressed_1	
Homo_sapiens_heat_shock_10kDa_protein_1_(chaperonin_10)	
Homo_sapiens_heat_shock_60kDa_protein_1_(chaperonin)	
Homo_sapiens_heat_shock_70kDa_protein_1A	
Homo_sapiens_heat_shock_90kDa_protein_1_alpha	
Homo_sapiens_heat_shock_90kDa_protein_1_beta	
Homo_sapiens_heat_shock_factor_binding_protein_1	
Homo_sapiens_heat_shock_transcription_factor_1	
Homo_sapiens_heat_shock_transcription_factor_Y-linked_1_transcript_variant_1	
Homo_sapiens_hematopoietic_cell-specific_Lyn_substrate_1	
Homo_sapiens_hemoglobin_gamma_A	
Homo_sapiens_hepatocellular_carcinoma-associated_antigen_127	
Homo_sapiens_hexokinase_1_transcript_variant_1	
Homo_sapiens_hexokinase_2	
Homo_sapiens_high-glucose-regulated_protein_8	
Homo_sapiens_high-mobility_group_20B	
Homo_sapiens_high-mobility_group_box_2	
Homo_sapiens_HIPK4_homeodomain_interacting_protein_kinase_4	
Homo_sapiens_HIST2H3C_histone_cluster_2_H3c	
Homo_sapiens_histone_1_H4i	
Homo_sapiens_histone_deacetylase_1	
Homo_sapiens_histone_deacetylase_3	
Homo_sapiens_HIV-1_rev_binding_protein_2	
Homo_sapiens_HIV-1_Tat_interactive_protein_2_30kDa	
Homo_sapiens_HLA-B_associated_transcript_8	
Homo_sapiens_HMBA-inducible	
Homo_sapiens_homeo_box_A1_transcript_variant_1	
Homo_sapiens_homeo_box_A9_transcript_variant_1	
Homo_sapiens_homeo_box_B13	
Homo_sapiens_homeo_box_B6_transcript_variant_2	
Homo_sapiens_homeo_box_B7	
Homo_sapiens_homeo_box_C10	
Homo_sapiens_homeo_box_C8	
Homo_sapiens_homeo_box_D3	
Homo_sapiens_homeodomain_interacting_protein_kinase_1_transcript_variant_4	
Homo_sapiens_homeodomain-only_protein_transcript_variant_1	
Homo_sapiens_homer_homolog_2_(Drosophila)_transcript_variant_1	
Homo_sapiens_hook1_protein	
Homo_sapiens_host_cell_factor_2	
Homo_sapiens_HOXA9_homeobox_A9	
Homo_sapiens_HOXC9_homeobox_C9	
Homo_sapiens_HRH1_histamine_receptor_H1	
Homo_sapiens_HRH2_histamine_receptor_H2	
Homo_sapiens_HSCARG_protein	
Homo_sapiens_HTR2B_5-hydroxytryptamine_(serotonin)_receptor_2B	
Homo_sapiens_human_T-cell_leukemia_virus_enhancer_factor	
Homo_sapiens_HUS1_checkpoint_homolog_(S._pombe)	
Homo_sapiens_hydroxyacyl_glutathione_hydrolase-like	
Homo_sapiens_hydroxyacylglutathione_hydrolase	
Homo_sapiens_hypothetical_protein_628	
Homo_sapiens_hypothetical_protein_BC007901_(LOC91461)	
Homo_sapiens_hypothetical_protein_DJ1042K10	
Homo_sapiens_hypothetical_protein_FLJ10377	
Homo_sapiens_hypothetical_protein_FLJ12089	
Homo_sapiens_hypothetical_protein_FLJ12577	
Homo_sapiens_hypothetical_protein_FLJ13081	
Homo_sapiens_hypothetical_protein_FLJ14813	
Homo_sapiens_hypothetical_protein_FLJ20274	
Homo_sapiens_hypothetical_protein_FLJ20432	
Homo_sapiens_hypothetical_protein_FLJ20574	
Homo_sapiens_hypothetical_protein_FLJ21901	
Homo_sapiens_hypothetical_protein_FLJ23356_(FLJ23356)	
Homo_sapiens_hypothetical_protein_FLJ34389	
Homo_sapiens_hypothetical_protein_MGC13096	
Homo_sapiens_hypothetical_protein_MGC16169	
Homo_sapiens_hypothetical_protein_MGC22688	
Homo_sapiens_hypothetical_protein_MGC2749	
Homo_sapiens_hypothetical_protein_MGC42105	
Homo_sapiens_hypothetical_protein_MGC45428	
Homo_sapiens_hypothetical_protein_MGC8407	
Homo_sapiens_hypoxanthine_phosphoribosyltransferase_1_(Lesch-Nyhan_syndrome)	
Homo_sapiens_hypoxia_inducible_factor_3_alpha_subunit	
Homo_sapiens_IL2-inducible_T-cell_kinase_(ITK)	
Homo_sapiens_immunoglobulin_heavy_constant_gamma_1_(G1m_marker)	
Homo_sapiens_IMP_(inosine_monophosphate)_dehydrogenase_1	
Homo_sapiens_increased_sodium_tolerance_1_homolog_(yeast)_(IST1)_mRNA	
Homo_sapiens_indoleamine-pyrrole_23_dioxygenase	
Homo_sapiens_inhibin_beta_A_(activin_A_activin_AB_alpha_polypeptide)	
Homo_sapiens_inhibitor_of_DNA_binding_2_dominant_negative_helix-loop-helix_protein	
Homo_sapiens_inhibitor_of_growth_family_member_4_transcript_variant_1	
Homo_sapiens_inhibitor_of_kappa_light_polypeptide_gene_enhancer_in_B-cells_kinase_beta	
Homo_sapiens_inhibitor_of_kappa_light_polypeptide_gene_enhancer_in_B-cells_kinase_epsilon_(IKBKE)	
Homo_sapiens_inositol_134-triphosphate_5/6_kinase	
Homo_sapiens_inositol_145-trisphosphate_3-kinase_B	
Homo_sapiens_inositol_hexaphosphate_kinase_1	
Homo_sapiens_inositol_polyphosphate_multikinase	
Homo_sapiens_inositol_polyphosphate-1-phosphatase	
Homo_sapiens_inositol_polyphosphate-5-phosphatase_75kDa	
Homo_sapiens_inositol(myo)-1(or_4)-monophosphatase_1	
Homo_sapiens_integrin-linked_kinase	
Homo_sapiens_interferon_gamma-inducible_protein_16	
Homo_sapiens_interferon_regulatory_factor_2	
Homo_sapiens_interferon_regulatory_factor_4	
Homo_sapiens_interferon_regulatory_factor_5_transcript_variant_2	
Homo_sapiens_interferon_stimulated_gene_20kDa	
Homo_sapiens_interferon-induced_protein_35	
Homo_sapiens_interferon-induced_protein_with_tetratricopeptide_repeats_1	
Homo_sapiens_interferon-induced_protein_with_tetratricopeptide_repeats_3	
Homo_sapiens_interferon-induced_protein_with_tetratricopeptide_repeats_5	
Homo_sapiens_interleukin_1_alpha	
Homo_sapiens_interleukin_1_beta	
Homo_sapiens_interleukin_1_family_member_5_(delta)_transcript_variant_2	
Homo_sapiens_interleukin_1_family_member_7_(zeta)_transcript_variant_1	
Homo_sapiens_interleukin_1_receptor_antagonist_transcript_variant_3	
Homo_sapiens_interleukin_18_(interferon-gamma-inducing_factor)	
Homo_sapiens_interleukin_21_receptor_transcript_variant_2	
Homo_sapiens_interleukin_24_transcript_variant_1	
Homo_sapiens_interleukin_8_receptor_beta	
Homo_sapiens_interleukin_enhancer_binding_factor_2_45kDa	
Homo_sapiens_interleukin-1_receptor-associated_kinase_1	
Homo_sapiens_interleukin-1_receptor-associated_kinase_4_mRNA_(cDNA_clone_MGC:13330_)	
Homo_sapiens_internexin_neuronal_intermediate_filament_protein_alpha	
Homo_sapiens_IP6K2_inositol_hexakisphosphate_kinase_2	
Homo_sapiens_ISL1_transcription_factor_LIM/homeodomain_(islet-1)	
Homo_sapiens_isopentenyl-diphosphate_delta_isomerase	
Homo_sapiens_JAK3_Janus_kinase_3	
Homo_sapiens_jun_B_proto-oncogene	
Homo_sapiens_kallikrein_3_(prostate_specific_antigen)_transcript_variant_1	
Homo_sapiens_katanin_p80_(WD_repeat_containing)_subunit_B_1	
Homo_sapiens_kelch-like_protein_C3IP1	
Homo_sapiens_keratin_14_(epidermolysis_bullosa_simplex_Dowling-Meara_Koebner)	
Homo_sapiens_keratin_15	
Homo_sapiens_keratin_19	
Homo_sapiens_keratin_4	
Homo_sapiens_keratin_8	
Homo_sapiens_KIAA0101_gene_product	
Homo_sapiens_KIAA0643_protein	
Homo_sapiens_KIAA1984	
Homo_sapiens_kinase_interacting_with_leukemia-associated_gene_(stathmin)	
Homo_sapiens_kinesin_family_member_9	
Homo_sapiens_KLF11_Kruppel-like_factor_11	
Homo_sapiens_Kruppel-like_factor_12_transcript_variant_1	
Homo_sapiens_Kruppel-like_factor_4_(gut)	
Homo_sapiens_Kruppel-like_factor_7_(ubiquitous)	
Homo_sapiens_l(3)mbt-like_2_(Drosophila)	
Homo_sapiens_lactate_dehydrogenase_A	
Homo_sapiens_lactate_dehydrogenase_B	
Homo_sapiens_LAG1_longevity_assurance_homolog_2_(S._cerevisiae)_transcript_variant_2	
Homo_sapiens_lamin_A/C_transcript_variant_2	
Homo_sapiens_leucine_rich_repeat_(in_FLII)_interacting_protein_2	
Homo_sapiens_leucine-zipper-like_transcription_regulator_1	
Homo_sapiens_leukotriene_A4_hydrolase	
Homo_sapiens_LHFP_lipoma_HMGIC_fusion_partner	
Homo_sapiens_ligand_of_numb-protein_X	
Homo_sapiens_likely_ortholog_of_rat_SNF1/AMP-activated_protein_kinase	
Homo_sapiens_LIM_and_senescent_cell_antigen-like_domains_1	
Homo_sapiens_LIM_and_SH3_protein_1	
Homo_sapiens_LIM_domain_binding_1	
Homo_sapiens_LIM_domain_binding_2	
Homo_sapiens_LIM_domain_kinase_2	
Homo_sapiens_LIM_domain_only_2_(rhombotin-like_1)	
Homo_sapiens_LIMK2_LIM_domain_kinase_2	
Homo_sapiens_lin-28_homolog_(C._elegans)	
Homo_sapiens_LRDD_leucine-rich_repeats_and_death_domain_containing	
Homo_sapiens_LSM1_homolog_U6_small_nuclear_RNA_associated_(S._cerevisiae)	
Homo_sapiens_lymphoblastic_leukemia_derived_sequence_1	
Homo_sapiens_lymphocyte_antigen_86	
Homo_sapiens_lymphocyte_antigen_96	
Homo_sapiens_lymphocyte_cytosolic_protein_1_(L-plastin)	
Homo_sapiens_lymphocyte-specific_protein_tyrosine_kinase	
Homo_sapiens_lymphoid_enhancer-binding_factor_1	
Homo_sapiens_macrophage_migration_inhibitory_factor_(glycosylation-inhibiting_factor)	
Homo_sapiens_MAD_mothers_against_decapentaplegic_homolog_2_(Drosophila)	
Homo_sapiens_MAD_mothers_against_decapentaplegic_homolog_4_(Drosophila)	
Homo_sapiens_MAD_mothers_against_decapentaplegic_homolog_5_(Drosophila)	
Homo_sapiens_MAD_mothers_against_decapentaplegic_homolog_9_(Drosophila)	
Homo_sapiens_male_germ_cell-associated_kinase	
Homo_sapiens_malic_enzyme_2_NAD(+)-dependent_mitochondrial	
Homo_sapiens_MAP_kinase_interacting_serine/threonine_kinase_2_mRNA_(cDNA_clone_MGC:90284_)	
Homo_sapiens_MAP_kinase-interacting_serine/threonine_kinase_1	
Homo_sapiens_MAP/microtubule_affinity-regulating_kinase_2_mRNA_(cDNA_clone_MGC:99619_)	
Homo_sapiens_MAP/microtubule_affinity-regulating_kinase_3	
Homo_sapiens_MAP1S_microtubule-associated_protein_1S	
Homo_sapiens_MAP3K13_mitogen-activated_protein_kinase_kinase_kinase_13	
Homo_sapiens_MAP3K14_mitogen-activated_protein_kinase_kinase_kinase_14	
Homo_sapiens_MAP3K20_sterile_alpha_motif_and_leucine_zipper_containing_kinase_AZK	
Homo_sapiens_MAP3K6_mitogen-activated_protein_kinase_kinase_kinase_6	
Homo_sapiens_MAP4_microtubule-associated_protein_4	
Homo_sapiens_MAPK6_mitogen-activated_protein_kinase_6	
Homo_sapiens_MAPKAPK3_mitogen-activated_protein_kinase-activated_protein_kinase_3	
Homo_sapiens_MAST1_microtubule_associated_serine/threonine_kinase_1	
Homo_sapiens_maternal_G10_transcript	
Homo_sapiens_mature_T-cell_proliferation_1	
Homo_sapiens_MAX_interactor_1_transcript_variant_3	
Homo_sapiens_MAX_protein_transcript_variant_2	
Homo_sapiens_MBD2_(methyl-CpG-binding_protein)-interacting_zinc_finger_protein	
Homo_sapiens_MED16_mediator_complex_subunit_16	
Homo_sapiens_megakaryocyte-associated_tyrosine_kinase_transcript_variant_1	
Homo_sapiens_Meis1_myeloid_ecotropic_viral_integration_site_1_homolog_3_(mouse)_transcript_variant_1	
Homo_sapiens_melanoma_antigen_family_A_4	
Homo_sapiens_melanophilin	
Homo_sapiens_membrane_protein_palmitoylated_1_55kDa	
Homo_sapiens_membrane_protein_palmitoylated_3_(MAGUK_p55_subfamily_member_3)	
Homo_sapiens_menage_a_trois_1_(CAK_assembly_factor)	
Homo_sapiens_mesenchyme_homeo_box_2_(growth_arrest-specific_homeo_box)	
Homo_sapiens_methyl_CpG_binding_protein_2_(Rett_syndrome)	
Homo_sapiens_methyltransferase_like_3	
Homo_sapiens_microphthalmia-associated_transcription_factor_transcript_variant_5	
Homo_sapiens_mitochondrial_ribosomal_protein_L45	
Homo_sapiens_mitochondrial_ribosomal_protein_L55	
Homo_sapiens_mitochondrial_ribosomal_protein_S26	
Homo_sapiens_mitochondrial_ribosomal_protein_S30	
Homo_sapiens_mitochondrial_translation_optimization_1_homolog_(S._cerevisiae)	
Homo_sapiens_mitogen-activated_protein_kinase_1_transcript_variant_2	
Homo_sapiens_mitogen-activated_protein_kinase_10_mRNA_(cDNA_clone_MGC:70580_)	
Homo_sapiens_mitogen-activated_protein_kinase_11	
Homo_sapiens_mitogen-activated_protein_kinase_12	
Homo_sapiens_mitogen-activated_protein_kinase_13	
Homo_sapiens_mitogen-activated_protein_kinase_14_transcript_variant_2	
Homo_sapiens_mitogen-activated_protein_kinase_3	
Homo_sapiens_mitogen-activated_protein_kinase_6	
Homo_sapiens_mitogen-activated_protein_kinase_7_transcript_variant_4	
Homo_sapiens_mitogen-activated_protein_kinase_8_(MAPK8)_transcript_variant_1	
Homo_sapiens_mitogen-activated_protein_kinase_8_(MAPK8)_transcript_variant_2	
Homo_sapiens_mitogen-activated_protein_kinase_9_transcript_variant_1	
Homo_sapiens_mitogen-activated_protein_kinase_kinase_1_(MAP2K1)	
Homo_sapiens_mitogen-activated_protein_kinase_kinase_1_interacting_protein_1	
Homo_sapiens_mitogen-activated_protein_kinase_kinase_3_transcript_variant_B	
Homo_sapiens_mitogen-activated_protein_kinase_kinase_5_transcript_variant_A	
Homo_sapiens_mitogen-activated_protein_kinase_kinase_6_transcript_variant_1	
Homo_sapiens_mitogen-activated_protein_kinase_kinase_7	
Homo_sapiens_mitogen-activated_protein_kinase_kinase_kinase_14	
Homo_sapiens_mitogen-activated_protein_kinase_kinase_kinase_2_(MAP3K2)	
Homo_sapiens_mitogen-activated_protein_kinase_kinase_kinase_6	
Homo_sapiens_mitogen-activated_protein_kinase_kinase_kinase_7_transcript_variant_A	
Homo_sapiens_mitogen-activated_protein_kinase_kinase_kinase_kinase_3_mRNA_(cDNA_clone_MGC:87206_)	
Homo_sapiens_mitogen-activated_protein_kinase_kinase_kinase_kinase_5	
Homo_sapiens_mitogen-activated_protein_kinase-activated_protein_kinase_3	
Homo_sapiens_mitogen-activated_protein_kinase-activated_protein_kinase_5_transcript_variant_1_mRNA_(cDNA_clone_MGC:54058_)	
Homo_sapiens_MLL_septin-like_fusion	
Homo_sapiens_MLLT6_myeloid/lymphoid_or_mixed-lineage_leukemia	
Homo_sapiens_MOB-LAK	
Homo_sapiens_moesin	
Homo_sapiens_Mst3_and_SOK1-related_kinase_(MASK)	
Homo_sapiens_Msx-interacting-zinc_finger_transcript_variant_alpha	
Homo_sapiens_muscle_skeletal_receptor_tyrosine_kinase_(MUSK)	
Homo_sapiens_musculin_(activated_B-cell_factor-1)	
Homo_sapiens_mutL_homolog_1_colon_cancer_nonpolyposis_type_2_(E._coli)	
Homo_sapiens_mutS_homolog_2_colon_cancer_nonpolyposis_type_1_(E._coli)	
Homo_sapiens_mutY_homolog_(E._coli)	
Homo_sapiens_MXD3_MAX_dimerization_protein_3	
Homo_sapiens_MYC-associated_zinc_finger_protein_(purine-binding_transcription_factor)	
Homo_sapiens_Mycbp-associated_protein	
Homo_sapiens_myeloid_cell_nuclear_differentiation_antigen	
Homo_sapiens_myeloid_differentiation_primary_response_gene_(88)	
Homo_sapiens_myeloid_leukemia_factor_1	
Homo_sapiens_myeloid/lymphoid_or_mixed-lineage_leukemia_(trithorax_homolog_Drosophila)	
Homo_sapiens_myogenic_factor_6_(herculin)	
Homo_sapiens_myogenin_(myogenic_factor_4)	
Homo_sapiens_myoneurin	
Homo_sapiens_myotubularin_related_protein_2_transcript_variant_1	
Homo_sapiens_myozenin_2	
Homo_sapiens_MYST_histone_acetyltransferase_2	
Homo_sapiens_myxovirus_(influenza_virus)_resistance_2_(mouse)	
Homo_sapiens_N-ethylmaleimide-sensitive_factor	
Homo_sapiens_N-myc_downstream_regulated_gene_1	
Homo_sapiens_NACHT_leucine_rich_repeat_and_PYD_containing_2	
Homo_sapiens_NADH_dehydrogenase_(ubiquinone)_1_alpha/beta_subcomplex_1_8kDa	
Homo_sapiens_NADH_dehydrogenase_(ubiquinone)_flavoprotein_3_10kDa	
Homo_sapiens_NCK_adaptor_protein_1	
Homo_sapiens_NDRG_family_member_2	
Homo_sapiens_NDRG2_NDRG_family_member_2	
Homo_sapiens_nemo_like_kinase_mRNA_(cDNA_clone_MGC:60309_)	
Homo_sapiens_nescient_helix_loop_helix_1	
Homo_sapiens_neural_precursor_cell_expressed_developmentally_down-regulated_9	
Homo_sapiens_neuroblastoma_RAS_viral_(v-ras)_oncogene_homolog	
Homo_sapiens_neuroendocrine_differentiation_factor	
Homo_sapiens_neurofibromin_2_(bilateral_acoustic_neuroma)_transcript_variant_1	
Homo_sapiens_neurogenic_differentiation_1	
Homo_sapiens_neurogenic_differentiation_4	
Homo_sapiens_neuropeptide_Y_receptor_Y5	
Homo_sapiens_neurotrophic_tyrosine_kinase_receptor_type_2	
Homo_sapiens_neurotrophic_tyrosine_kinase_receptor_type_3_transcript_variant_3	
Homo_sapiens_neutrophil_cytosolic_factor_2_(65kDa_chronic_granulomatous_disease_autosomal_2)	
Homo_sapiens_NFATC4_nuclear_factor_of_activated_T-cells_cytoplasmic_calcineurin-dependent_4	
Homo_sapiens_NFX1_nuclear_transcription_factor_X-box_binding_1	
Homo_sapiens_NGFI-A_binding_protein_1_(EGR1_binding_protein_1)	
Homo_sapiens_nicolin_1	
Homo_sapiens_NIMA_(never_in_mitosis_gene_a)-_related_kinase_11	
Homo_sapiens_NIMA_(never_in_mitosis_gene_a)-related_kinase_3_transcript_variant_1	
Homo_sapiens_NIMA_(never_in_mitosis_gene_a)-related_kinase_7_(NEK7)	
Homo_sapiens_NK2_transcription_factor_related_locus_5_(Drosophila)	
Homo_sapiens_non-metastatic_cells_4_protein_expressed_in	
Homo_sapiens_non-metastatic_cells_5_protein_expressed_in_(nucleoside-diphosphate_kinase)	
Homo_sapiens_non-metastatic_cells_6_protein_expressed_in_(nucleoside-diphosphate_kinase)	
Homo_sapiens_non-metastatic_cells_7_protein_expressed_in_(nucleoside-diphosphate_kinase)_transcript_variant_1	
Homo_sapiens_nuclear_DNA-binding_protein_transcript_variant_1	
Homo_sapiens_nuclear_factor_(erythroid-derived_2)_45kDa	
Homo_sapiens_nuclear_factor_(erythroid-derived_2)-like_2	
Homo_sapiens_nuclear_factor_I/A	
Homo_sapiens_nuclear_factor_I/B	
Homo_sapiens_nuclear_factor_interleukin_3_regulated	
Homo_sapiens_nuclear_receptor_binding_factor_2	
Homo_sapiens_nuclear_receptor_binding_protein_2_(NRBP2)	
Homo_sapiens_nuclear_receptor_coactivator_4	
Homo_sapiens_nuclear_receptor_coactivator_5	
Homo_sapiens_nuclear_receptor_interacting_protein_1	
Homo_sapiens_nuclear_receptor_interacting_protein_3	
Homo_sapiens_nuclear_receptor_subfamily_0_group_B_member_2	
Homo_sapiens_nuclear_receptor_subfamily_1_group_D_member_2	
Homo_sapiens_nuclear_receptor_subfamily_1_group_H_member_2	
Homo_sapiens_nuclear_receptor_subfamily_1_group_I_member_2	
Homo_sapiens_nuclear_receptor_subfamily_2_group_C_member_1	
Homo_sapiens_nuclear_receptor_subfamily_2_group_C_member_2	
Homo_sapiens_nuclear_receptor_subfamily_2_group_E_member_1	
Homo_sapiens_nuclear_receptor_subfamily_2_group_E_member_3	
Homo_sapiens_nuclear_receptor_subfamily_3_group_C_member_1_(glucocorticoid_receptor)	
Homo_sapiens_nuclear_receptor_subfamily_4_group_A_member_1_transcript_variant_1	
Homo_sapiens_nuclear_receptor_subfamily_4_group_A_member_2_transcript_variant_1	
Homo_sapiens_nuclear_receptor_subfamily_6_group_A_member_1_transcript_variant_2	
Homo_sapiens_nuclear_respiratory_factor_1	
Homo_sapiens_nuclear_transcription_factor_Y_alpha	
Homo_sapiens_nuclear_transcription_factor_Y_beta	
Homo_sapiens_nucleophosmin_(nucleolar_phosphoprotein_B23_numatrin)	
Homo_sapiens_nucleosomal_binding_protein_1	
Homo_sapiens_nucleosome_assembly_protein_1-like_1_transcript_variant_1	
Homo_sapiens_nucleosome_assembly_protein_1-like_3	
Homo_sapiens_nucleotide_binding_protein_2_(MinD_homolog_E._coli)	
Homo_sapiens_nudE_nuclear_distribution_gene_E_homolog_1_(A._nidulans)	
Homo_sapiens_NUP50_nucleoporin_50kDa	
Homo_sapiens_NUP98_nucleoporin	
Homo_sapiens_oligodendrocyte_transcription_factor_3	
Homo_sapiens_ornithine_decarboxylase_1	
Homo_sapiens_OTX1_orthodenticle_homeobox_1	
Homo_sapiens_ovo-like_1(Drosophila)	
Homo_sapiens_oxidative-stress_responsive_1	
Homo_sapiens_oxysterol_binding_protein-like_9_transcript_variant_1	
Homo_sapiens_p21_(CDKN1A)-activated_kinase_2_mRNA_(cDNA_clone_MGC:97077_)	
Homo_sapiens_p21(CDKN1A)-activated_kinase_4	
Homo_sapiens_p21(CDKN1A)-activated_kinase_6	
Homo_sapiens_p21(CDKN1A)-activated_kinase_7_transcript_variant_2_mRNA_(cDNA_clone_MGC:26232_)	
Homo_sapiens_p53	
Homo_sapiens_p53_target_zinc_finger_protein_transcript_variant_1	
Homo_sapiens_p66_alpha	
Homo_sapiens_paired_box_gene_8_transcript_variant_PAX8A	
Homo_sapiens_paired-like_homeodomain_transcription_factor_2_transcript_variant_3	
Homo_sapiens_palate_lung_and_nasal_epithelium_carcinoma_associated_transcript_variant_1	
Homo_sapiens_pantothenate_kinase_3	
Homo_sapiens_PBX/knotted_1_homeobox_1_transcript_variant_1	
Homo_sapiens_PCTAIRE_protein_kinase_1_transcript_variant_2	
Homo_sapiens_PCTAIRE_protein_kinase_1_transcript_variant_3	
Homo_sapiens_PCTAIRE_protein_kinase_2	
Homo_sapiens_PCTAIRE_protein_kinase_3_transcript_variant_3	
Homo_sapiens_PDGFRB_platelet-derived_growth_factor_receptor_beta_polypeptide	
Homo_sapiens_PDK2_pyruvate_dehydrogenase_kinase_isozyme_2	
Homo_sapiens_peanut-like_1_(Drosophila)	
Homo_sapiens_pelota_homolog_(Drosophila)	
Homo_sapiens_PEPP_subfamily_gene_2	
Homo_sapiens_peptidylprolyl_isomerase_D_(cyclophilin_D)	
Homo_sapiens_peroxiredoxin_6	
Homo_sapiens_peroxisomal_D3D2-enoyl-CoA_isomerase	
Homo_sapiens_peroxisome_proliferative_activated_receptor_delta_transcript_variant_2	
Homo_sapiens_peroxisome_proliferative_activated_receptor_gamma_transcript_variant_3	
Homo_sapiens_PFTAIRE_protein_kinase_1_(PFTK1)_OriGene_unique_variant_1	
Homo_sapiens_PHD_finger_protein_1_transcript_variant_2	
Homo_sapiens_PHD_finger_protein_11	
Homo_sapiens_PHD_finger_protein_17	
Homo_sapiens_PHD_finger_protein_5A	
Homo_sapiens_PHD_finger_protein_7_transcript_variant_1	
Homo_sapiens_phosducin-like_3	
Homo_sapiens_phosphatase_and_tensin_homolog_(mutated_in_multiple_advanced_cancer	
Homo_sapiens_phosphatidylinositol-4-phosphate_5-kinase_type_II_beta_transcript_variant_2	
Homo_sapiens_phosphatidylinositol-4-phosphate_5-kinase_type_II_gamma	
Homo_sapiens_phosphoenolpyruvate_carboxykinase_2_(mitochondrial)	
Homo_sapiens_phosphofructokinase_platelet	
Homo_sapiens_phosphoinositide-3-kinase_class_3	
Homo_sapiens_phospholipase_D2	
Homo_sapiens_phosphomevalonate_kinase	
Homo_sapiens_phosphoribosyl_pyrophosphate_amidotransferase	
Homo_sapiens_phosphoribosyl_pyrophosphate_synthetase_2	
Homo_sapiens_phosphorylase_glycogen_brain	
Homo_sapiens_phosphorylase_kinase_gamma_1_(muscle)_mRNA_(cDNA_clone_MGC:59809_)	
Homo_sapiens_phosphorylase_kinase_gamma_2_(testis)	
Homo_sapiens_pim-1_oncogene	
Homo_sapiens_pim-2_oncogene	
Homo_sapiens_PIM2_pim-2_oncogene	
Homo_sapiens_PIP5K1B_phosphatidylinositol-4-phosphate_5-kinase_type_I_beta	
Homo_sapiens_Pirin	
Homo_sapiens_pitrilysin_metalloproteinase_1	
Homo_sapiens_PKE_protein_kinase	
Homo_sapiens_platelet-derived_growth_factor_beta_polypeptide_(simian_sarcoma_viral_(v-sis	
Homo_sapiens_platelet-derived_growth_factor_receptor_alpha_polypeptide	
Homo_sapiens_platelet-derived_growth_factor_receptor_alpha_polypeptide_mRNA_(cDNA_clone_MGC:74795_)	
Homo_sapiens_platelet-derived_growth_factor_receptor_beta_polypeptide	
Homo_sapiens_platelet-derived_growth_factor_receptor-like	
Homo_sapiens_pleckstrin_homology_domain_interacting_protein	
Homo_sapiens_pleckstrin_homology-like_domain_family_A_member_1	
Homo_sapiens_pleckstrin_homology-like_domain_family_A_member_2	
Homo_sapiens_pleiomorphic_adenoma_gene-like_2	
Homo_sapiens_PMAIP1_phorbol-12-myristate-13-acetate-induced_protein_1	
Homo_sapiens_polo_(Drosophia)-like_kinase_clone_MGC:8502	
Homo_sapiens_poly(A)_binding_protein_cytoplasmic_1	
Homo_sapiens_poly(rC)_binding_protein_2_transcript_variant_2	
Homo_sapiens_polyamine-modulated_factor_1	
Homo_sapiens_polyglutamine_binding_protein_1	
Homo_sapiens_polymerase_(RNA)_II_(DNA_directed)_polypeptide_E_25kDa	
Homo_sapiens_polymerase_(RNA)_II_(DNA_directed)_polypeptide_I_14.5kDa	
Homo_sapiens_polyribonucleotide_nucleotidyltransferase_1	
Homo_sapiens_potassium_channel_modulatory_factor_1	
Homo_sapiens_POU_domain_class_2_associating_factor_1	
Homo_sapiens_POU_domain_class_2_transcription_factor_2	
Homo_sapiens_POU_domain_class_5_transcription_factor_1	
Homo_sapiens_POU3F2_POU_class_3_homeobox_2	
Homo_sapiens_PPP2R1A_protein_phosphatase_2_regulatory_subunit_A_alpha	
Homo_sapiens_PPP2R1B_protein_phosphatase_2_regulatory_subunit_A_beta	
Homo_sapiens_PR_domain_containing_4	
Homo_sapiens_PRCC_papillary_renal_cell_carcinoma_(translocation-associated)	
Homo_sapiens_pre-B-cell_leukemia_transcription_factor_3	
Homo_sapiens_preimplantation_protein_3_transcript_variant_1	
Homo_sapiens_primase_polypeptide_1_49kDa	
Homo_sapiens_PRKD2_protein_kinase_D2	
Homo_sapiens_profilin_2_transcript_variant_1	
Homo_sapiens_programmed_cell_death_5	
Homo_sapiens_programmed_cell_death_6	
Homo_sapiens_prohibitin	
Homo_sapiens_prohibitin_2	
Homo_sapiens_prostaglandin_D2_receptor_(DP)	
Homo_sapiens_prostaglandin_E_receptor_3_(subtype_EP3)_transcript_variant_6	
Homo_sapiens_prostate_epithelium-specific_Ets_transcription_factor	
Homo_sapiens_proteasome_(prosome_macropain)_26S_subunit_non-ATPase_9	
Homo_sapiens_proteasome_(prosome_macropain)_activator_subunit_1_(PA28_alpha)_transcript_variant_1	
Homo_sapiens_proteasome_(prosome_macropain)_activator_subunit_2_(PA28_beta)	
Homo_sapiens_proteasome_(prosome_macropain)_subunit_beta_type_3	
Homo_sapiens_proteasome_(prosome_macropain)_subunit_beta_type_8_(large_multifunctional_protease_7)_transcript_variant_1	
Homo_sapiens_protein_(peptidyl-prolyl_cis/trans_isomerase)_NIMA-interacting_1	
Homo_sapiens_protein_kinase_AMP-activated_alpha_1_catalytic_subunit_mRNA_(cDNA_clone_MGC:57364_)	
Homo_sapiens_protein_kinase_AMP-activated_alpha_2_catalytic_subunit_mRNA_(cDNA_clone_MGC:97312_)	
Homo_sapiens_protein_kinase_AMP-activated_gamma_3_non-catalytic_subunit_(PRKAG3)	
Homo_sapiens_protein_kinase_C_and_casein_kinase_substrate_in_neurons_3	
Homo_sapiens_protein_kinase_C_beta_1	
Homo_sapiens_protein_kinase_C_binding_protein_1	
Homo_sapiens_protein_kinase_C_eta	
Homo_sapiens_protein_kinase_C_iota	
Homo_sapiens_protein_kinase_C_zeta	
Homo_sapiens_protein_kinase_cAMP-dependent_catalytic_beta	
Homo_sapiens_protein_kinase_cAMP-dependent_catalytic_gamma	
Homo_sapiens_protein_kinase_cAMP-dependent_regulatory_type_I_alpha_(tissue_specific_e	
Homo_sapiens_protein_kinase_D2	
Homo_sapiens_protein_kinase_H11	
Homo_sapiens_protein_kinase_membrane_associated_tyrosine/threonine_1_(PKMYT1)_transcript_variant_1	
Homo_sapiens_protein_kinase_X-linked_mRNA_(cDNA_clone_MGC:52228_)	
Homo_sapiens_protein_phosphatase_1_regulatory_(inhibitor)_subunit_14A	
Homo_sapiens_protein_phosphatase_1_regulatory_(inhibitor)_subunit_2_pseudogene_9	
Homo_sapiens_protein_phosphatase_2_(formerly_2A)_catalytic_subunit_beta_isoform	
Homo_sapiens_protein_phosphatase_2_regulatory_subunit_B_(B56)_alpha_isoform	
Homo_sapiens_protein_phosphatase_2A_regulatory_subunit_B'_(PR_53)_transcript_variant_3	
Homo_sapiens_protein_phosphatase_4_(formerly_X)_catalytic_subunit	
Homo_sapiens_protein_phosphatase_4_regulatory_subunit_1	
Homo_sapiens_protein_regulator_of_cytokinesis_1	
Homo_sapiens_protein_tyrosine_phosphatase_non-receptor_type_1	
Homo_sapiens_protein_tyrosine_phosphatase_non-receptor_type_11_(Noonan_syndrome_1)	
Homo_sapiens_protein_tyrosine_phosphatase_non-receptor_type_2_transcript_variant_3	
Homo_sapiens_protein_tyrosine_phosphatase_non-receptor_type_22_(lymphoid)	
Homo_sapiens_protein_tyrosine_phosphatase_non-receptor_type_4_(megakaryocyte)	
Homo_sapiens_protein_tyrosine_phosphatase_non-receptor_type_6_transcript_variant_2	
Homo_sapiens_protein_tyrosine_phosphatase_type_IVA_member_1	
Homo_sapiens_protein_tyrosine_phosphatase_type_IVA_member_2_transcript_variant_1	
Homo_sapiens_protein_tyrosine_phosphatase_type_IVA_member_3_transcript_variant_2	
Homo_sapiens_PRPF4_PRP4_pre-mRNA_processing_factor_4_homolog_(yeast)	
Homo_sapiens_PRPS1L1_phosphoribosyl_pyrophosphate_synthetase_1-like_1	
Homo_sapiens_PSKH1_protein_serine_kinase_H1	
Homo_sapiens_PSMB10_proteasome_(prosome_macropain)_subunit_beta_type_10	
Homo_sapiens_PTK2_protein_tyrosine_kinase_2	
Homo_sapiens_PTK6_protein_tyrosine_kinase_6_(PTK6)	
Homo_sapiens_PTK7_protein_tyrosine_kinase_7_transcript_variant_PTK7-1	
Homo_sapiens_PTK9_protein_tyrosine_kinase_9	
Homo_sapiens_PTK9L_protein_tyrosine_kinase_9-like_(A6-related_protein)	
Homo_sapiens_putative_homeodomain_transcription_factor_1	
Homo_sapiens_PX_domain_containing_serine/threonine_kinase	
Homo_sapiens_px19-like_protein	
Homo_sapiens_pygopus_2	
Homo_sapiens_pyrroline-5-carboxylate_reductase_1_transcript_variant_1	
Homo_sapiens_pyruvate_carboxylase	
Homo_sapiens_pyruvate_dehydrogenase_kinase_isoenzyme_1	
Homo_sapiens_pyruvate_dehydrogenase_kinase_isoenzyme_2	
Homo_sapiens_pyruvate_dehydrogenase_kinase_isoenzyme_3	
Homo_sapiens_pyruvate_dehydrogenase_kinase_isoenzyme_4	
Homo_sapiens_pyruvate_kinase_liver_and_RBC_transcript_variant_1	
Homo_sapiens_pyruvate_kinase_muscle_transcript_variant_1	
Homo_sapiens_RAB11_family_interacting_protein_3_(class_II)	
Homo_sapiens_RABEP1_rabaptin_RAB_GTPase_binding_effector_protein_1	
Homo_sapiens_RAD21_RAD21_homolog_(S._pombe)	
Homo_sapiens_RAD23_homolog_A_(S._cerevisiae)	
Homo_sapiens_RAD23_homolog_B_(S._cerevisiae)	
Homo_sapiens_RAD51_homolog_(RecA_homolog_E._coli)_(S._cerevisiae)_transcript_variant_2	
Homo_sapiens_RAD51-like_1_(S._cerevisiae)	
Homo_sapiens_RAD51-like_3_(S._cerevisiae)_transcript_variant_1	
Homo_sapiens_RAG1_recombination_activating_gene_1	
Homo_sapiens_ralA_binding_protein_1	
Homo_sapiens_RAN_member_RAS_oncogene_family	
Homo_sapiens_RAP1_GTP-GDP_dissociation_stimulator_1	
Homo_sapiens_RAR-related_orphan_receptor_C	
Homo_sapiens_ras_homolog_gene_family_member_A	
Homo_sapiens_ras_homolog_gene_family_member_B	
Homo_sapiens_ras_homolog_gene_family_member_T2	
Homo_sapiens_RAS-like_estrogen-regulated_growth_inhibitor	
Homo_sapiens_Ras-related_GTP_binding_C	
Homo_sapiens_RD_RNA_binding_protein	
Homo_sapiens_receptor_(TNFRSF)-interacting_serine-threonine_kinase_1_(RIPK1)	
Homo_sapiens_receptor_interacting_protein_kinase_5_transcript_variant_2_mRNA_(cDNA_clone_MGC:61657_)	
Homo_sapiens_receptor-interacting_serine-threonine_kinase_2	
Homo_sapiens_receptor-interacting_serine-threonine_kinase_3_mRNA_(cDNA_clone_MGC:75066_)	
Homo_sapiens_regulator_of_G-protein_signalling_19_interacting_protein_1	
Homo_sapiens_related_RAS_viral_(r-ras)_oncogene_homolog	
Homo_sapiens_related_RAS_viral_(r-ras)_oncogene_homolog_2	
Homo_sapiens_renal_tumor_antigen_mRNA_(cDNA_clone_MGC:61453_)	
Homo_sapiens_ret_proto-oncogene_(multiple_endocrine_neoplasia_and_medullary_thyroid_carci	
Homo_sapiens_ret_proto-oncogene_(multiple_endocrine_neoplasia_and_medullary_thyroid_carcinoma_1_Hirschsprung_disease)_transcript_variant_4	
Homo_sapiens_retinoblastoma_1_(including_osteosarcoma)	
Homo_sapiens_retinoic_acid_receptor_alpha	
Homo_sapiens_retinoic_acid_receptor_beta_transcript_variant_1	
Homo_sapiens_retinoid_X_receptor_beta	
Homo_sapiens_retinoid_X_receptor_gamma	
Homo_sapiens_Rho_GDP_dissociation_inhibitor_(GDI)_beta	
Homo_sapiens_riboflavin_kinase	
Homo_sapiens_ribokinase	
Homo_sapiens_ribonuclease_L_(2'5'-oligoisoadenylate_synthetase-dependent)_(RNASEL)	
Homo_sapiens_ribosomal_protein_L10	
Homo_sapiens_ribosomal_protein_L10a	
Homo_sapiens_ribosomal_protein_L11	
Homo_sapiens_ribosomal_protein_L13a	
Homo_sapiens_ribosomal_protein_L18	
Homo_sapiens_ribosomal_protein_L18a	
Homo_sapiens_ribosomal_protein_L27a	
Homo_sapiens_ribosomal_protein_L28	
Homo_sapiens_ribosomal_protein_L30	
Homo_sapiens_ribosomal_protein_L31	
Homo_sapiens_ribosomal_protein_L32	
Homo_sapiens_ribosomal_protein_L34_transcript_variant_2	
Homo_sapiens_ribosomal_protein_L37a	
Homo_sapiens_ribosomal_protein_large_P1	
Homo_sapiens_ribosomal_protein_S2	
Homo_sapiens_ribosomal_protein_S6_kinase_70kDa_polypeptide_1_mRNA_(cDNA_clone_MGC:61512_)	
Homo_sapiens_ribosomal_protein_S6_kinase_70kDa_polypeptide_2_transcript_variant_1	
Homo_sapiens_ribosomal_protein_S6_kinase_90kDa_polypeptide_1	
Homo_sapiens_ribosomal_protein_S6_kinase_90kDa_polypeptide_2	
Homo_sapiens_ribosomal_protein_S6_kinase_90kDa_polypeptide_3_(RPS6KA3)_OriGene_unique_variant_1	
Homo_sapiens_ribosomal_protein_S6_kinase_90kDa_polypeptide_5_transcript_variant_2	
Homo_sapiens_ribosomal_protein_S6_kinase_90kDa_polypeptide_6_(RPS6KA6)	
Homo_sapiens_ribosomal_protein_S6_kinase-like_1	
Homo_sapiens_ribosomal_protein_S7	
Homo_sapiens_ring_finger_protein_(C3H2C3_type)_6_transcript_variant_1	
Homo_sapiens_ring_finger_protein_1	
Homo_sapiens_ring_finger_protein_110	
Homo_sapiens_ring_finger_protein_12_transcript_variant_1	
Homo_sapiens_ring_finger_protein_40_transcript_variant_1	
Homo_sapiens_ring_finger_protein_7_transcript_variant_1	
Homo_sapiens_RIO_kinase_2_(yeast)	
Homo_sapiens_RIO_kinase_3_(yeast)	
Homo_sapiens_RNA_binding_motif_and_ELMO_domain_1	
Homo_sapiens_RNA_binding_motif_protein_6	
Homo_sapiens_RNA_binding_motif_protein_7	
Homo_sapiens_RNA_guanylyltransferase_and_5'-phosphatase	
Homo_sapiens_RNF38_ring_finger_protein_38	
Homo_sapiens_RPL15_ribosomal_protein_L15	
Homo_sapiens_RPL22_ribosomal_protein_L22	
Homo_sapiens_RPS6KA4_ribosomal_protein_S6_kinase_90kDa_polypeptide_4	
Homo_sapiens_RUN_and_FYVE_domain_containing_1	
Homo_sapiens_RuvB-like_1_(E._coli)	
Homo_sapiens_S-adenosylhomocysteine_hydrolase	
Homo_sapiens_S100_calcium_binding_protein_A6_(calcyclin)	
Homo_sapiens_S100_calcium_binding_protein_A8_(calgranulin_A)	
Homo_sapiens_S100_calcium_binding_protein_A9_(calgranulin_B)	
Homo_sapiens_salvador_homolog_1_(Drosophila)	
Homo_sapiens_SART3_squamous_cell_carcinoma_antigen_recognized_by_T_cells_3	
Homo_sapiens_SBDS_Shwachman-Bodian-Diamond_syndrome	
Homo_sapiens_SCAN_domain_containing_1_transcript_variant_2	
Homo_sapiens_SEC14L2_SEC14-like_2_(S._cerevisiae)	
Homo_sapiens_SECIS_binding_protein_2	
Homo_sapiens_secreted_protein_acidic_cysteine-rich_(osteonectin)	
Homo_sapiens_septin_4_transcript_variant_3	
Homo_sapiens_serine_(or_cysteine)_proteinase_inhibitor_clade_B_(ovalbumin)_member_5	
Homo_sapiens_serine_(or_cysteine)_proteinase_inhibitor_clade_F_(alpha-2_antiplasmin_pigment_epithelium_derived_factor)_member_2	
Homo_sapiens_serine/threonine_kinase_10_mRNA_(cDNA_clone_MGC:87394_)	
Homo_sapiens_serine/threonine_kinase_11_(Peutz-Jeghers_syndrome)	
Homo_sapiens_serine/threonine_kinase_12_clone_MGC:8406	
Homo_sapiens_serine/threonine_kinase_16	
Homo_sapiens_serine/threonine_kinase_17b_(apoptosis-inducing)	
Homo_sapiens_serine/threonine_kinase_18	
Homo_sapiens_serine/threonine_kinase_22C_(spermiogenesis_associated)	
Homo_sapiens_serine/threonine_kinase_22D_(spermiogenesis_associated)	
Homo_sapiens_serine/threonine_kinase_24_(STE20_homolog_yeast)	
Homo_sapiens_serine/threonine_kinase_25_(STE20_homolog_yeast)	
Homo_sapiens_serine/threonine_kinase_3_(STE20_homolog_yeast)	
Homo_sapiens_serine/threonine_kinase_32B_mRNA_(cDNA_clone_MGC:46065_)	
Homo_sapiens_serine/threonine_kinase_33	
Homo_sapiens_serine/threonine_kinase_38	
Homo_sapiens_serine/threonine_kinase_38_like	
Homo_sapiens_serine/threonine_kinase_4_(STK4)	
Homo_sapiens_serine/threonine_kinase_6_transcript_variant_1	
Homo_sapiens_serine/threonine/tyrosine_interacting_protein	
Homo_sapiens_serologically_defined_breast_cancer_antigen_NY-BR-20	
Homo_sapiens_serologically_defined_colon_cancer_antigen_10	
Homo_sapiens_serologically_defined_colon_cancer_antigen_16	
Homo_sapiens_serologically_defined_colon_cancer_antigen_8	
Homo_sapiens_serum-inducible_kinase	
Homo_sapiens_serum/glucocorticoid_regulated_kinase	
Homo_sapiens_serum/glucocorticoid_regulated_kinase_2_mRNA_(cDNA_clone_MGC:74468_)	
Homo_sapiens_serum/glucocorticoid_regulated_kinase-like_transcript_variant_1	
Homo_sapiens_SET_translocation_(myeloid_leukemia-associated)	
Homo_sapiens_seven_in_absentia_homolog_1_(Drosophila)_transcript_variant_2	
Homo_sapiens_sex_comb_on_midleg_homolog_1_(Drosophila)	
Homo_sapiens_SFRS_protein_kinase_1	
Homo_sapiens_SFRS_protein_kinase_2_transcript_variant_2	
Homo_sapiens_SGOL1_shugoshin-like_1_(S._pombe)	
Homo_sapiens_SH2_domain_protein_1A_Duncan's_disease_(lymphoproliferative_syndrome)	
Homo_sapiens_SH2-B_homolog	
Homo_sapiens_SH3_domain_binding_glutamic_acid-rich_protein_like_3	
Homo_sapiens_SH3-domain_GRB2-like_1	
Homo_sapiens_SH3-domain_GRB2-like_endophilin_B1	
Homo_sapiens_signal_recognition_particle_19kDa	
Homo_sapiens_signal_transducer_and_activator_of_transcription_1_91kDa_transcript_varian	
Homo_sapiens_signal_transducer_and_activator_of_transcription_4	
Homo_sapiens_signal_transducer_and_activator_of_transcription_5A	
Homo_sapiens_signal_transducing_adaptor_molecule_(SH3_domain_and_ITAM_motif)_1	
Homo_sapiens_signal_transducing_adaptor_molecule_(SH3_domain_and_ITAM_motif)_2	
Homo_sapiens_SIK2_salt-inducible_kinase_2	
Homo_sapiens_Similar_to_collagen_type_IV_alpha_3_(Goodpasture_antigen)_binding_protein_clone_MGC:1410	
Homo_sapiens_Similar_to_FGFR1_oncogene_partner	
Homo_sapiens_similar_to_ras_homolog_gene_family_member_H	
Homo_sapiens_Similar_to_septin_6	
Homo_sapiens_Similar_to_Wiskott-Aldrich_syndrome_(eczema-thrombocytopenia)	
Homo_sapiens_sine_oculis_homeobox_homolog_1_(Drosophila)	
Homo_sapiens_single_stranded_DNA_binding_protein_3	
Homo_sapiens_single_stranded_DNA_binding_protein_4	
Homo_sapiens_Sjogren_syndrome_antigen_A2_(60kDa_ribonucleoprotein_autoantigen_SS-A/Ro)	
Homo_sapiens_Sjogren's_syndrome_nuclear_autoantigen_1	
Homo_sapiens_SMT3_suppressor_of_mif_two_3_homolog_2_(yeast)	
Homo_sapiens_sorbitol_dehydrogenase	
Homo_sapiens_sorting_nexin_6_transcript_variant_1	
Homo_sapiens_Sp1_transcription_factor	
Homo_sapiens_SP110_nuclear_body_protein_transcript_variant_b	
Homo_sapiens_Sp2_transcription_factor	
Homo_sapiens_spastic_paraplegia_20_spartin_(Troyer_syndrome)	
Homo_sapiens_Spi-B_transcription_factor_(Spi-1/PU.1_related)	
Homo_sapiens_Spi-C_transcription_factor_(Spi-1/PU.1_related)	
Homo_sapiens_spleen_tyrosine_kinase	
Homo_sapiens_splicing_factor_arginine/serine-rich_5	
Homo_sapiens_SRB7_suppressor_of_RNA_polymerase_B_homolog_(yeast)	
Homo_sapiens_src_family_associated_phosphoprotein_1	
Homo_sapiens_src_homology_3_domain-containing_protein_HIP-55	
Homo_sapiens_Src-like-adaptor	
Homo_sapiens_Src-like-adaptor_2_transcript_variant_1	
Homo_sapiens_SRM_spermidine_synthase	
Homo_sapiens_SRY_(sex_determining_region_Y)-box_10	
Homo_sapiens_SRY_(sex_determining_region_Y)-box_15	
Homo_sapiens_SRY_(sex_determining_region_Y)-box_2	
Homo_sapiens_START_domain_containing_7_transcript_variant_2	
Homo_sapiens_stathmin_1/oncoprotein_18	
Homo_sapiens_staufen_RNA_binding_protein_(Drosophila)_transcript_variant_T3	
Homo_sapiens_STE20-like_kinase	
Homo_sapiens_sterile_alpha_motif_and_leucine_zipper_containing_kinase_AZK	
Homo_sapiens_sterol_carrier_protein_2_transcript_variant_2	
Homo_sapiens_STIP1_homology_and_U-Box_containing_protein_1	
Homo_sapiens_STRADA_STE20-related_kinase_adaptor_alpha	
Homo_sapiens_stress-induced-phosphoprotein_1_(Hsp70/Hsp90-organizing_protein)	
Homo_sapiens_succinate_dehydrogenase_complex_subunit_B_iron_sulfur_(Ip)	
Homo_sapiens_succinate-CoA_ligase_ADP-forming_beta_subunit	
Homo_sapiens_superoxide_dismutase_1_soluble_(amyotrophic_lateral_sclerosis_1_(adult))	
Homo_sapiens_superoxide_dismutase_2_mitochondrial	
Homo_sapiens_suppressor_of_cytokine_signaling_2	
Homo_sapiens_suppressor_of_cytokine_signaling_3	
Homo_sapiens_suppressor_of_cytokine_signaling_4	
Homo_sapiens_suppressor_of_cytokine_signaling_5	
Homo_sapiens_suppressor_of_fused_homolog_(Drosophila)	
Homo_sapiens_suppressor_of_Ty_4_homolog_1_(S._cerevisiae)	
Homo_sapiens_surfeit_5_transcript_variant_c	
Homo_sapiens_survival_of_motor_neuron_1_telomeric	
Homo_sapiens_SWI/SNF_related_matrix_associated_actin_dependent_regulator_of_chromatin	
Homo_sapiens_SWI/SNF_related_matrix_associated_actin_dependent_regulator_of_chromatin_subfamily_d_member_1	
Homo_sapiens_synovial_sarcoma_translocation_gene_on_chromosome_18-like_1	
Homo_sapiens_synovial_sarcoma_X_breakpoint_1	
Homo_sapiens_synovial_sarcoma_X_breakpoint_2_transcript_variant_2	
Homo_sapiens_synovial_sarcoma_X_breakpoint_3_transcript_variant_2	
Homo_sapiens_synovial_sarcoma_X_breakpoint_4_transcript_variant_1	
Homo_sapiens_synuclein_alpha_(non_A4_component_of_amyloid_precursor)_transcript_variant_NACP140	
Homo_sapiens_T-box_5_transcript_variant_4	
Homo_sapiens_T-box_6_transcript_variant_1	
Homo_sapiens_T-cell_leukemia_homeobox_2_transcript_variant_1	
Homo_sapiens_T-cell_leukemia/lymphoma_1A	
Homo_sapiens_T-LAK_cell-originated_protein_kinase	
Homo_sapiens_TAF15_RNA_polymerase_II_TATA_box_binding_protein_(TBP)-associated_factor_68kDa	
Homo_sapiens_TAF5-like_RNA_polymerase_II_p300/CBP-associated_factor_(PCAF)-associated_factor_65kDa	
Homo_sapiens_TANK-binding_kinase_1	
Homo_sapiens_TAR_DNA_binding_protein	
Homo_sapiens_target_of_myb1_(chicken)	
Homo_sapiens_TBC1_domain_family_member_5	
Homo_sapiens_TBC1D2_TBC1_domain_family_member_2	
Homo_sapiens_TBK1_TANK-binding_kinase_1	
Homo_sapiens_TBP-like_1	
Homo_sapiens_TCF21_transcription_factor_21	
Homo_sapiens_TCF3_(E2A)_fusion_partner_(in_childhood_Leukemia)	
Homo_sapiens_TDRD3_tudor_domain_containing_3	
Homo_sapiens_TDRKH_tudor_and_KH_domain_containing	
Homo_sapiens_TEA_domain_family_member_2	
Homo_sapiens_TEAD3_TEA_domain_family_member_3	
Homo_sapiens_TEK_tyrosine_kinase_endothelial	
Homo_sapiens_TEK_tyrosine_kinase_endothelial_(venous_malformations_multiple_cutaneous_a	
Homo_sapiens_testis_zinc_finger_protein	
Homo_sapiens_testis-specific_kinase_2_mRNA_(cDNA_clone_MGC:45651_)	
Homo_sapiens_TFIIA-alpha/beta-like_factor_transcript_variant_1	
Homo_sapiens_TGFB_inducible_early_growth_response	
Homo_sapiens_TGFB-induced_factor_(TALE_family_homeobox)_transcript_variant_4	
Homo_sapiens_TGFB-induced_factor_2_(TALE_family_homeobox)	
Homo_sapiens_thioredoxin_2	
Homo_sapiens_thioredoxin_domain_containing_3_(spermatozoa)	
Homo_sapiens_thioredoxin_reductase_1_transcript_variant_5	
Homo_sapiens_thioredoxin-like_clone_MGC:12349	
Homo_sapiens_thymidine_kinase_1_soluble	
Homo_sapiens_thyroid_hormone_receptor_beta_(erythroblastic_leukemia_viral_(v-erb-a)_oncogene_homolog_2_avian)_(THRB)	
Homo_sapiens_thyroid_hormone_receptor_interactor_3	
Homo_sapiens_thyroid_hormone_receptor_interactor_6	
Homo_sapiens_thyroid_hormone_receptor-associated_protein_(100_kDa)	
Homo_sapiens_TIA1_cytotoxic_granule-associated_RNA_binding_protein	
Homo_sapiens_TIE1_tyrosine_kinase_with_immunoglobulin-like_and_EGF-like_domains_1	
Homo_sapiens_TKT_transketolase	
Homo_sapiens_TNF_receptor-associated_factor_1	
Homo_sapiens_TNF_receptor-associated_factor_2_transcript_variant_1	
Homo_sapiens_TNF_receptor-associated_factor_3_interacting_protein_1	
Homo_sapiens_TNF_receptor-associated_factor_4_transcript_variant_1	
Homo_sapiens_TNF_receptor-associated_factor_5_transcript_variant_2	
Homo_sapiens_TNF_receptor-associated_factor_6_transcript_variant_1	
Homo_sapiens_TNIP1_TNFAIP3_interacting_protein_1	
Homo_sapiens_toll_interacting_protein	
Homo_sapiens_toll-interleukin_1_receptor_(TIR)_domain_containing_adaptor_protein	
Homo_sapiens_tousled-like_kinase_1	
Homo_sapiens_tousled-like_kinase_2_mRNA_(cDNA_clone_MGC:44450_)	
Homo_sapiens_TPBG_trophoblast_glycoprotein	
Homo_sapiens_TRAF_and_TNF_receptor_associated_protein	
Homo_sapiens_TRAF_interacting_protein	
Homo_sapiens_transcription_elongation_factor_A_(SII)_2	
Homo_sapiens_transcription_elongation_factor_A_(SII)-like_1	
Homo_sapiens_transcription_elongation_factor_B_(SIII)_polypeptide_3_(110kDa_elongin_A)	
Homo_sapiens_transcription_factor_(p38_interacting_protein)	
Homo_sapiens_transcription_factor_12_(HTF4_helix-loop-helix_transcription_factors_4)	
Homo_sapiens_transcription_factor_4	
Homo_sapiens_transcription_factor_AP-4_(activating_enhancer_binding_protein_4)	
Homo_sapiens_transcription_factor_binding_to_IGHM_enhancer_3	
Homo_sapiens_transcription_factor_CP2	
Homo_sapiens_transcription_factor_CP2-like_1	
Homo_sapiens_transcription_factor_Dp-1	
Homo_sapiens_transcription_factor_Dp-2_(E2F_dimerization_partner_2)	
Homo_sapiens_transcription_factor_EB	
Homo_sapiens_transcription_factor_EC	
Homo_sapiens_transcription_factor-like_1	
Homo_sapiens_transcription_factor-like_4_transcript_variant_2	
Homo_sapiens_transcription_termination_factor_mitochondrial	
Homo_sapiens_transcription_termination_factor_RNA_polymerase_II	
Homo_sapiens_transcriptional_adaptor_2_(ADA2_homolog_yeast)-like_transcript_variant_1	
Homo_sapiens_transcriptional_adaptor_3_(NGG1_homolog_yeast)-like_transcript_variant_2	
Homo_sapiens_transcriptional_co-activator_with_PDZ-binding_motif_(TAZ)	
Homo_sapiens_transducin_(beta)-like_1X-linked	
Homo_sapiens_transferrin_receptor_(p90_CD71)	
Homo_sapiens_transforming_acidic_coiled-coil_containing_protein_1	
Homo_sapiens_transforming_growth_factor_beta_receptor_II_(70/80kDa)_mRNA_(cDNA_clone_MGC:33800_)	
Homo_sapiens_translational_inhibitor_protein_p14	
Homo_sapiens_TRAP/Mediator_complex_component	
Homo_sapiens_TRIB3_tribbles_homolog_3_(Drosophila)	
Homo_sapiens_tribbles_homolog_2	
Homo_sapiens_triosephosphate_isomerase_1	
Homo_sapiens_TRIP11_thyroid_hormone_receptor_interactor_11	
Homo_sapiens_tripartite_motif-containing_32	
Homo_sapiens_tripartite_motif-containing_37	
Homo_sapiens_TRK-fused_gene	
Homo_sapiens_tropomyosin_1_(alpha)	
Homo_sapiens_tropomyosin_3	
Homo_sapiens_tropomyosin_4	
Homo_sapiens_TSC-22-like	
Homo_sapiens_TSSK2_testis-specific_serine_kinase_2	
Homo_sapiens_TTBK2_tau_tubulin_kinase_2	
Homo_sapiens_TTK_protein_kinase	
Homo_sapiens_tubulin_alpha_1_(testis_specific)	
Homo_sapiens_tubulin_beta_polypeptide	
Homo_sapiens_tubulin_gamma_complex_associated_protein_3	
Homo_sapiens_tumor_necrosis_factor_alpha-induced_protein_6	
Homo_sapiens_tumor_necrosis_factor_alpha-induced_protein_8	
Homo_sapiens_tumor_necrosis_factor_receptor_superfamily_member_11b_(osteoprotegerin)	
Homo_sapiens_tumor_necrosis_factor_receptor_superfamily_member_6_transcript_variant_1	
Homo_sapiens_tumor_protein_D52	
Homo_sapiens_tumor_protein_p73-like	
Homo_sapiens_tumor_susceptibility_gene_101	
Homo_sapiens_twist_homolog_2_(Drosophila)	
Homo_sapiens_TYR_tyrosinase_(oculocutaneous_albinism_IA)	
Homo_sapiens_TYRO3_protein_tyrosine_kinase	
Homo_sapiens_tyrosine_3-monooxygenase/tryptophan_5-monooxygenase_activation_protein_gamma_polypeptide	
Homo_sapiens_tyrosine_kinase_with_immunoglobulin-like_and_EGF-like_domains_1	
Homo_sapiens_tyrosyl-tRNA_synthetase	
Homo_sapiens_ubiquinol-cytochrome_c_reductase_core_protein_I	
Homo_sapiens_ubiquitin_activating_enzyme_E1-like_protein	
Homo_sapiens_ubiquitin_specific_protease_10	
Homo_sapiens_ubiquitin-activating_enzyme_E1C_(UBA3_homolog_yeast)_transcript_variant_1	
Homo_sapiens_ubiquitin-conjugating_enzyme_E2_variant_1	
Homo_sapiens_ubiquitously-expressed_transcript	
Homo_sapiens_UBP1_upstream_binding_protein_1_(LBP-1a)	
Homo_sapiens_UHMK1_U2AF_homology_motif_(UHM)_kinase_1	
Homo_sapiens_unc-51-like_kinase_2_(C._elegans)	
Homo_sapiens_upstream_transcription_factor_1	
Homo_sapiens_upstream_transcription_factor_2_c-fos_interacting_transcript_variant_1	
Homo_sapiens_uridine_monophosphate_kinase	
Homo_sapiens_uridine-cytidine_kinase_1-like_1	
Homo_sapiens_Usher_syndrome_1C_(autosomal_recessive_severe)	
Homo_sapiens_v-akt_murine_thymoma_viral_oncogene_homolog_1	
Homo_sapiens_v-akt_murine_thymoma_viral_oncogene_homolog_3_(protein_kinase_B_gamma)_(AKT3)_transcript_variant_1	
Homo_sapiens_v-erb-b2_erythroblastic_leukemia_viral_oncogene_homolog_3_(avian)	
Homo_sapiens_v-ets_erythroblastosis_virus_E26_oncogene_homolog_2_(avian)	
Homo_sapiens_v-fos_FBJ_murine_osteosarcoma_viral_oncogene_homolog	
Homo_sapiens_v-Ha-ras_Harvey_rat_sarcoma_viral_oncogene_homolog	
Homo_sapiens_v-Ki-ras2_Kirsten_rat_sarcoma_2_viral_oncogene_homolog_transcript_variant_b	
Homo_sapiens_v-kit_Hardy-Zuckerman_4_feline_sarcoma_viral_oncogene_homolog	
Homo_sapiens_v-kit_Hardy-Zuckerman_4_feline_sarcoma_viral_oncogene_homolog_mRNA_(cDNA_clone_MGC:87427_)	
Homo_sapiens_v-maf_musculoaponeurotic_fibrosarcoma_oncogene_homolog_G_(avian)	
Homo_sapiens_v-myb_myeloblastosis_viral_oncogene_homolog_(avian)-like_2	
Homo_sapiens_v-myc_myelocytomatosis_viral_oncogene_homolog_(avian)	
Homo_sapiens_v-raf_murine_sarcoma_3611_viral_oncogene_homolog_1	
Homo_sapiens_v-raf-1_murine_leukemia_viral_oncogene_homolog_1	
Homo_sapiens_v-src_sarcoma_(Schmidt-Ruppin_A-2)_viral_oncogene_homolog_(avian)	
Homo_sapiens_v-yes-1_Yamaguchi_sarcoma_viral_related_oncogene_homolog_mRNA_(cDNA_clone_MGC:104151_)	
Homo_sapiens_vaccinia_related_kinase_3	
Homo_sapiens_vacuolar_protein_sorting_45A_(yeast)	
Homo_sapiens_vacuolar_protein_sorting_4A_(yeast)	
Homo_sapiens_vascular_endothelial_growth_factor_B	
Homo_sapiens_vav_1_oncogene	
Homo_sapiens_ventral_anterior_homeobox_2	
Homo_sapiens_vestigial_like_1_(Drosophila)	
Homo_sapiens_VHL_von_Hippel-Lindau_tumor_suppressor	
Homo_sapiens_villin_2_(ezrin)	
Homo_sapiens_vimentin	
Homo_sapiens_vinculin	
Homo_sapiens_vitamin_D_(125-_dihydroxyvitamin_D3)_receptor	
Homo_sapiens_vitamin_D_receptor_interacting_protein	
Homo_sapiens_VPS54_vacuolar_protein_sorting_54_homolog_(S._cerevisiae)	
Homo_sapiens_Wilms_tumor_1	
Homo_sapiens_WWOX_WW_domain_containing_oxidoreductase	
Homo_sapiens_X-box_binding_protein_1	
Homo_sapiens_XPMC2_prevents_mitotic_catastrophe_2_homolog_(Xenopus_laevis)	
Homo_sapiens_xylulokinase_homolog_(H._influenzae)	
Homo_sapiens_YY1_associated_factor_2	
Homo_sapiens_ZBTB16_zinc_finger_and_BTB_domain_containing_16	
Homo_sapiens_ZBTB7B_zinc_finger_and_BTB_domain_containing_7B	
Homo_sapiens_zeta-chain_(TCR)_associated_protein_kinase_70kDa	
Homo_sapiens_zinc_finger_and_SCAN_domain_containing_18	
Homo_sapiens_zinc_finger_matrin_type_2	
Homo_sapiens_zinc_finger_protein	
Homo_sapiens_zinc_finger_protein_(C2H2_type)_277	
Homo_sapiens_zinc_finger_protein_136_(clone_pHZ-20)	
Homo_sapiens_zinc_finger_protein_143_(clone_pHZ-1)	
Homo_sapiens_zinc_finger_protein_145_(Kruppel-like_expressed_in_promyelocytic_leukemia)	
Homo_sapiens_zinc_finger_protein_147_(estrogen-responsive_finger_protein)	
Homo_sapiens_zinc_finger_protein_165	
Homo_sapiens_zinc_finger_protein_169	
Homo_sapiens_zinc_finger_protein_174	
Homo_sapiens_zinc_finger_protein_187	
Homo_sapiens_zinc_finger_protein_19_(KOX_12)	
Homo_sapiens_zinc_finger_protein_193	
Homo_sapiens_zinc_finger_protein_198	
Homo_sapiens_zinc_finger_protein_202	
Homo_sapiens_zinc_finger_protein_207	
Homo_sapiens_zinc_finger_protein_232	
Homo_sapiens_zinc_finger_protein_256	
Homo_sapiens_zinc_finger_protein_274_transcript_variant_ZNF274c	
Homo_sapiens_zinc_finger_protein_276_homolog_(mouse)	
Homo_sapiens_zinc_finger_protein_278_transcript_variant_4	
Homo_sapiens_zinc_finger_protein_3_(A8-51)	
Homo_sapiens_zinc_finger_protein_305	
Homo_sapiens_zinc_finger_protein_306	
Homo_sapiens_zinc_finger_protein_307	
Homo_sapiens_zinc_finger_protein_323	
Homo_sapiens_zinc_finger_protein_331	
Homo_sapiens_zinc_finger_protein_346	
Homo_sapiens_zinc_finger_protein_35_(clone_HF.10)	
Homo_sapiens_zinc_finger_protein_354A	
Homo_sapiens_zinc_finger_protein_36_C3H_type-like_1	
Homo_sapiens_zinc_finger_protein_38	
Homo_sapiens_zinc_finger_protein_41_transcript_variant_2	
Homo_sapiens_zinc_finger_protein_435	
Homo_sapiens_zinc_finger_protein_444	
Homo_sapiens_zinc_finger_protein_449	
Homo_sapiens_zinc_finger_protein_45_(a_Kruppel-associated_box_(KRAB)_domain_polypeptide)	
Homo_sapiens_zinc_finger_protein_46_(KUP)	
Homo_sapiens_zinc_finger_protein_496	
Homo_sapiens_zinc_finger_protein_70_(Cos17)	
Homo_sapiens_zinc_finger_protein_95_homolog_(mouse)	
Homo_sapiens_zinc_finger_protein_99	
Homo_sapiens_zinc_finger_protein_subfamily_1A_1_(Ikaros)	
Homo_sapiens_zinc_finger_protein_subfamily_1A_3_(Aiolos)_transcript_variant_1	
Homo_sapiens_zinc_fingers_and_homeoboxes_2	
Homo_sapiens_zinc_ribbon_domain_containing_1_transcript_variant_b	
Homo_sapiens_ZKSCAN1_zinc_finger_with_KRAB_and_SCAN_domains_1	
Homo_sapiens_ZNF37A_zinc_finger_protein_37A	
Homo_sapiens_ZNF384_zinc_finger_protein_384	
Homo_sapiens_ZNF398_zinc_finger_protein_398	
Homo_sapiensmal_T-cell_differentiation_protein	
HORMA_domain_containing_1	
hypothetical_protein_LOC130576	
hypothetical_protein_LOC196993	
iga1	control
iga2	control
iga3	control
iga4	control
iga5	control
iga6	control
IGF2_insulin-like_growth_factor_2_(somatomedin_A)_[_Homo_sapiens_]_	
IGF2BP1_insulin-like_growth_factor_2_mRNA_binding_protein_1_[_Homo_sapiens_]_(IMP1)	
IGF2BP3_insulin-like_growth_factor_2_mRNA_binding_protein_3_[_Homo_sapiens_]_(Koc_KH_domain_containing_protein_overexpressed_in_cancer)	
igg1	control
igg2	control
igg3	control
igg4	control
igg5	control
igg6	control
igm1	control
igm2	control
igm3	control
igm4	control
igm5	control
igm6	control
integrin_beta_6	
integrin_beta-like_1_(with_EGF-like_repeat_domains)	
interferon_induced_transmembrane_protein_1_(9-27)	
junction_plakoglobin	
ladinin_1	
lectin_galactoside-binding_soluble_7	
legumain_[Homo_sapiens]	
LEM_domain_containing_1	
LGALS1_lectin_galactoside-binding_soluble_1_[_Homo_sapiens_]_	
Macrophage_capping_protein_gelsolin-like_(CAPG)_	
mal_T-cell_differentiation_protein-like	
matrilin_3	
Matrix_metallopeptidase_	
matrix_metallopeptidase_11_(stromelysin_3)	
matrix_metallopeptidase_14_(membrane-inserted)	
MDM2_Mdm2_p53_binding_protein_homolog_(mouse)_[_Homo_sapiens_]	
melan-A_[_Homo_sapiens_]	
membrane_protein_palmitoylated_5_(MAGUK_p55_subfamily_member_5)_	
mesothelin_[Homo_sapiens]	
myelin_protein_zero-like_2	
NAGK_N-acetylglucosamine_kinase_[_Homo_sapiens_]_	
NAP1L4_nucleosome_assembly_protein_1-like_4_[_Homo_sapiens_]_	
NPM1_nucleophosmin_(nucleolar_phosphoprotein_B23_numatrin)_[_Homo_sapiens_]	
NUCB1_nucleobindin_1_(calnuc)	
Opa_interacting_protein_5	
paired_box__3	
paired_box_5_[Homo_sapiens]	
PAS_domain_containing_1	
Paxillin_(PXN)_	
peptidylprolyl_isomerase_C_(cyclophilin_C)	
phosphatidylethanolamine_binding_protein_1	
Pituitary_tumor-transforming_1_interacting_protein_	
piwi-like_2_(Drosophila)	
placenta-specific_1	
PRDX1_peroxiredoxin_1_[_Homo_sapiens_]_	
pregnancy_specific_beta-1-glycoprotein_11	
premelanosome_protein_[_Homo_sapiens_]	
PRKACA_protein_kinase_cAMP-dependent_catalytic_alpha_[_Homo_sapiens_]	
PRL_prolactin_[_Homo_sapiens_]_	
Prolactin-induced_protein_	
prostate_stem_cell_antigen_[Homo_sapiens]	
Prostatic_acid_phosphotase_	
proteasome_(prosome_macropain)_subunit_beta_type_9_(large_multifunctional_peptidase_2)_[Homo_sapiens]	
Protein_Phosphatase_1_	
PSG1_pregnancy_specific_beta-1-glycoprotein_1_[_Homo_sapiens_]_	
PSIP1_PC4_and_SFRS1_interacting_protein_1_[_Homo_sapiens_]_(LEDGF/p75)	
PSMA6_proteasome_(prosome_macropain)_subunit_alpha_type_6_[_Homo_sapiens_]_	
RAB38_RAB38_member_RAS_oncogene_family_[_Homo_sapiens_]_(NY-MEL-1)	
RBPJ_recombination_signal_binding_protein_for_immunoglobulin_kappa_J_region_[_Homo_sapiens_]_	
regenerating_islet-derived_3_alpha	
Regulator_of_chromosome_condensation_2_(RCC2)_	
regulator_of_G-protein_signaling_5_[Homo_sapiens]	
Rho_GDP_dissociation_inhibitor_(GDI)_gamma_[Homo_sapiens]	
Ribosomal_protein_L17_	
Ribosomal_protein_L5_	
Ribosomal_protein_L7a_	
Ribosomal_protein_S27a_	
RNA_binding_motif_protein_46	
ropporin_rhophilin_associated_protein_1	
RPA2_replication_protein_A2_32kDa_[_Homo_sapiens_]_	
RPS15A_ribosomal_protein_S15a_[_Homo_sapiens_]_	
S100_calcium_binding_protein_A7	
S100P_S100_calcium_binding_protein_P_[_Homo_sapiens_]_	
SCGB1D2_secretoglobin_family_1D_member_2_(lipophilin_B)	
sciellin	
SDCCAG3_serologically_defined_colon_cancer_antigen_3_[_Homo_sapiens_]_	
Serine/threonine-protein_kinase_B-raf	
serpin_peptidase_inhibitor_clade_E_(nexin_plasminogen_activator_inhibitor_type_1)_member_2	
SFN_stratifin_[_Homo_sapiens_]_(YWHAS)	
solute_carrier_organic_anion_transporter_family_member_6A1	
SPARC-like_1_(hevin)	
sperm_acrosome_associated_3	
sperm_associated_antigen_9	
SQSTM1_sequestosome_1_[_Homo_sapiens_]__(p62)	
SSB_Sjogren_syndrome_antigen_B_(autoantigen_La)	
statin_[Homo_sapiens]	
sushi-repeat-containing_protein_X-linked_2	
synaptonemal_complex_central_element_protein_1	
Synaptonemal_complex_protein_SC65	
telomerase_reverse_transcriptase_[_Homo_sapiens_]	
testis-specific_serine_kinase_6	
Theg_homolog_(mouse)	
TP73_tumor_protein_p73_[_Homo_sapiens_]	
transgelin_	
TSC22_domain_family_member_1_(TSC22D1)_	
tubby_like_protein_2	
tumor-associated_calcium_signal_transducer_2	
TYMS_thymidylate_synthetase_[_Homo_sapiens_]	
TYRP1_tyrosinase-related_protein_1_[_Homo_sapiens_]	
UBE2Q1_ubiquitin-conjugating_enzyme_E2Q_family_member_1_[_Homo_sapiens_]_	
Ubiquitin_carboxyl-terminal_esterase_L3_(ubiquitin_thiolesterase)	
v-erb-b2_erythroblastic_leukemia_viral_oncogene_homolog_2_neuro/glioblastoma_derived_oncogene_homolog_(avian)_[_Homo_sapiens_]	
v-myc_myelocytomatosis_viral_related_oncogene_neuroblastoma_derived_(avian)_[Homo_sapiens]	
WNT1_inducible_signaling_pathway_protein_3	
ZNF282_zinc_finger_protein_282_[_Homo_sapiens_]_(also_known_as_HUB1:HTLV-I_U5RE_binding_protein_1)	